1705839854699, 50, 61, 10, 51, 56.016906, 84.000000, 25259
1705839880327, 50, 64, 10, 54, 57.400635, 86.000000, 18922
1705839899307, 50, 14, 2, 12, 258.266741, 369.000000, 176
1705839899535, 50, 64, 10, 54, 54.348145, 81.000000, 22032
1705839921618, 50, 87, 14, 73, 40.690553, 61.000000, 64030
1705839985702, 50, 72, 12, 60, 52.326341, 79.000000, 56202
1705840041958, 50, 62, 10, 52, 58.812752, 88.000000, 17064
1705840059075, 50, 72, 12, 60, 46.043620, 69.000000, 33141
1705840092280, 50, 34, 5, 29, 104.779412, 157.000000, 2046
1705840094377, 50, 31, 5, 26, 118.855343, 178.000000, 2047
1705840098694, 50, 85, 14, 71, 41.482261, 62.000000, 83764
1705840182838, 50, 36, 6, 30, 103.582899, 155.000000, 6849
1705840189748, 50, 108, 18, 90, 32.372396, 48.000000, 137212
1705840327023, 50, 91, 15, 76, 40.669128, 61.000000, 54169
1705840381248, 50, 112, 18, 94, 31.026088, 47.000000, 102723
1705840484030, 50, 82, 13, 69, 43.487900, 65.000000, 44453
1705840528537, 50, 110, 18, 92, 33.173793, 49.000000, 116755
1705840645349, 50, 37, 6, 31, 104.350929, 156.000000, 3156
1705840648560, 50, 37, 6, 31, 100.912584, 151.000000, 3342
1705840651963, 50, 61, 10, 51, 57.355277, 86.000000, 13985
1705840668470, 50, 45, 7, 38, 80.236458, 120.000000, 10580
1705840679433, 50, 110, 18, 92, 32.032493, 49.000000, 170323
1705840849819, 50, 50, 8, 42, 76.300000, 114.000000, 8890
1705840858759, 50, 112, 18, 94, 30.177874, 45.000000, 97611
1705840956444, 50, 67, 11, 56, 49.183769, 73.000000, 26369
1705840982866, 50, 21, 3, 18, 170.103051, 252.000000, 668
1705840983599, 50, 26, 4, 22, 141.771334, 206.000000, 1097
1705840984752, 50, 32, 5, 27, 118.518066, 164.000000, 1936
1705840986741, 50, 117, 19, 98, 27.606838, 41.000000, 133565
1705841120365, 50, 64, 10, 54, 56.733276, 85.000000, 27558
1705841318765, 50, 57, 9, 48, 61.901042, 92.000000, 17833
1705841407820, 50, 82, 13, 69, 49.556784, 74.000000, 59368
1705841467588, 50, 36, 6, 30, 101.125000, 147.000000, 7831
1705841475477, 50, 31, 5, 26, 116.621472, 174.000000, 2533
1705841478075, 50, 14, 2, 12, 281.258929, 419.000000, 149
1705841478282, 50, 18, 3, 15, 191.014757, 279.000000, 422
1705841478761, 50, 50, 8, 42, 69.103906, 103.000000, 9562
1705841488379, 50, 91, 15, 76, 40.506095, 60.000000, 65041
1705841553485, 50, 56, 9, 47, 64.702846, 97.000000, 12605
1705841566143, 50, 106, 17, 89, 34.753390, 53.000000, 84346
1705841650555, 50, 97, 16, 81, 37.591656, 57.000000, 65963
1705841719246, 50, 21, 3, 18, 175.014881, 255.000000, 875
1705841720460, 50, 20, 3, 17, 190.835156, 284.000000, 513
1705841721024, 50, 16, 2, 14, 243.972656, 363.000000, 182
1705841721257, 50, 111, 18, 93, 31.318975, 46.000000, 108230
1705841829566, 50, 18, 3, 15, 169.960938, 254.000000, 514
1705841830130, 50, 57, 9, 48, 64.088542, 96.000000, 15702
1705841845889, 50, 115, 19, 96, 30.875000, 45.000000, 133984
1705841979946, 50, 19, 3, 16, 190.468750, 284.000000, 371
1705841980382, 50, 24, 4, 20, 148.313802, 214.000000, 956
1705841981407, 50, 79, 13, 66, 45.170095, 66.000000, 36314
1705842020746, 50, 106, 17, 89, 35.137087, 51.000000, 155906
1705842177032, 50, 69, 11, 58, 49.414629, 74.000000, 35206
1705842212290, 50, 50, 8, 42, 67.965000, 101.000000, 16194
1705842228550, 50, 67, 11, 56, 57.771688, 86.000000, 42749
1705842271352, 50, 55, 9, 46, 61.965909, 93.000000, 18860
1705842290265, 50, 69, 11, 58, 52.103714, 78.000000, 35398
1705842325718, 50, 109, 18, 91, 29.129157, 43.000000, 144351
1705842470124, 50, 36, 6, 30, 98.623210, 147.000000, 9047
1705842479223, 50, 30, 5, 25, 135.180859, 202.000000, 4423
1705842483710, 50, 26, 4, 22, 132.418570, 195.000000, 2031
1705842488634, 50, 28, 4, 24, 134.707031, 195.000000, 1931
1705842490963, 50, 40, 6, 34, 89.700317, 133.000000, 9061
1705842500090, 50, 80, 13, 67, 45.719482, 68.000000, 54004
1705842554149, 50, 60, 10, 50, 58.949089, 89.000000, 23918
1705842578124, 50, 32, 5, 27, 111.101074, 163.000000, 2136
1705842580311, 50, 25, 4, 21, 141.412324, 210.000000, 1781
1705842582146, 50, 14, 2, 12, 241.632813, 345.000000, 164
1705842582364, 50, 112, 18, 94, 31.325335, 46.000000, 104903
1705842687347, 50, 100, 16, 84, 36.475781, 54.000000, 85598
1705842773002, 50, 42, 7, 35, 91.464286, 137.000000, 6255
1705842781928, 50, 100, 16, 84, 34.505313, 51.000000, 99798
1705842882078, 50, 48, 8, 40, 75.146484, 112.000000, 10047
1705842892193, 50, 69, 11, 58, 53.981658, 80.000000, 23495
1705842915752, 50, 103, 17, 86, 34.731493, 53.000000, 79185
1705842994993, 50, 68, 11, 57, 51.691176, 77.000000, 22034
1705843017079, 50, 112, 18, 94, 31.918387, 46.000000, 99423
1705843116569, 50, 49, 8, 41, 78.096301, 117.000000, 8514
1705843125134, 50, 108, 18, 90, 34.864131, 53.000000, 153400
1705843278598, 50, 85, 14, 71, 42.243566, 63.000000, 43413
1705843322067, 50, 104, 17, 87, 35.043269, 53.000000, 95000
1705843421241, 50, 96, 16, 80, 32.624919, 49.000000, 95544
1705843517144, 50, 32, 5, 27, 106.099121, 155.000000, 2081
1705843519282, 50, 108, 18, 90, 34.113137, 49.000000, 92813
1705843612167, 50, 70, 11, 59, 48.424330, 73.000000, 31046
1705843643266, 50, 33, 5, 28, 102.556818, 153.000000, 1991
1705843645312, 50, 44, 7, 37, 81.573153, 118.000000, 5476
1705843650840, 50, 78, 13, 65, 41.733774, 62.000000, 35066
1705843685971, 50, 15, 2, 13, 241.530208, 361.000000, 162
1705843686193, 50, 118, 19, 99, 29.813294, 45.000000, 130059
1705843816319, 50, 100, 16, 84, 35.352266, 51.000000, 79707
1705843900142, 50, 26, 4, 22, 127.268630, 188.000000, 1960
1705843902486, 50, 43, 7, 36, 89.407703, 134.000000, 6987
1705843909537, 50, 42, 7, 35, 87.084728, 130.000000, 9561
1705843919154, 50, 60, 10, 50, 63.952344, 95.000000, 18901
1705843938116, 50, 84, 14, 70, 43.170573, 64.000000, 46280
1705843984487, 50, 117, 19, 98, 30.228766, 45.000000, 160495
1705844145076, 50, 13, 2, 11, 292.992788, 433.000000, 132
1705844145268, 50, 70, 11, 59, 51.734487, 77.000000, 30128
1705844175464, 50, 50, 8, 42, 70.304375, 103.000000, 10644
1705844186734, 50, 40, 6, 34, 93.866895, 140.000000, 5098
1705844194078, 50, 84, 14, 70, 40.858445, 61.000000, 77849
1705844272296, 50, 18, 3, 15, 216.599175, 324.000000, 732
1705844273087, 50, 84, 14, 70, 43.409412, 65.000000, 45754
1705844318897, 50, 30, 5, 25, 125.479167, 186.000000, 1747
1705844320696, 50, 112, 18, 94, 29.979074, 44.000000, 104157
1705844424908, 50, 60, 10, 50, 62.357682, 90.000000, 20373
1705844445336, 50, 39, 6, 33, 93.724960, 140.000000, 4022
1705844449418, 50, 31, 5, 26, 123.645035, 185.000000, 2427
1705844451896, 50, 60, 10, 50, 63.159180, 95.000000, 25494
1705844477472, 50, 63, 10, 53, 50.869296, 76.000000, 17512
1705844497610, 50, 82, 13, 69, 45.008194, 61.000000, 55995
1705844553953, 50, 60, 10, 50, 61.993750, 92.000000, 26282
1705844580290, 50, 115, 19, 96, 32.217391, 48.000000, 140193
1705844720548, 50, 111, 18, 93, 28.751408, 41.000000, 100949
1705844821605, 50, 52, 8, 44, 74.970102, 110.000000, 11806
1705844833463, 50, 49, 8, 41, 72.430166, 104.000000, 10927
1705844844453, 50, 15, 2, 13, 246.604167, 366.000000, 149
1705844844657, 50, 61, 10, 51, 68.612321, 99.000000, 20977
1705844865696, 50, 99, 16, 83, 36.865925, 54.000000, 94510
1705844960277, 50, 45, 7, 38, 76.725694, 115.000000, 6561
1705844969358, 50, 88, 14, 74, 39.572088, 59.000000, 67937
1705845037661, 50, 75, 12, 63, 47.975000, 71.000000, 44712
1705845082429, 50, 105, 17, 88, 31.025316, 46.000000, 131205
1705845213691, 50, 38, 6, 32, 88.234606, 132.000000, 7804
1705845221547, 50, 93, 15, 78, 40.263861, 60.000000, 65716
1705845287316, 50, 108, 18, 90, 32.448568, 49.000000, 108197
1705845395568, 50, 50, 8, 42, 70.801582, 100.000000, 17371
1705845412999, 50, 55, 9, 46, 69.797159, 103.000000, 12496
1705845425555, 50, 111, 18, 93, 31.290857, 46.000000, 192975
1705845618601, 50, 73, 12, 61, 52.475706, 79.000000, 35889
1705845657236, 50, 78, 13, 65, 40.687099, 61.000000, 53919
1705845711509, 50, 99, 16, 83, 36.932331, 55.000000, 163786
1705845875365, 50, 76, 12, 64, 47.599712, 71.000000, 47555
1705845922987, 50, 56, 9, 47, 65.657506, 98.000000, 15682
1705845938723, 50, 114, 19, 95, 35.425439, 53.000000, 145918
1705846084707, 50, 87, 14, 73, 41.961566, 62.000000, 57111
1705846141887, 50, 118, 19, 99, 29.523967, 45.000000, 131102
1705846273057, 50, 38, 6, 32, 81.286801, 121.000000, 6439
1705846279557, 50, 63, 10, 53, 56.383433, 84.000000, 21201
1705846300812, 50, 40, 6, 34, 93.969922, 140.000000, 3216
1705846306370, 50, 12, 2, 10, 275.876953, 410.000000, 377
1705846307093, 50, 114, 19, 95, 31.041667, 44.000000, 134127
1705846441280, 50, 114, 19, 95, 30.169271, 45.000000, 130076
1705846571421, 50, 30, 5, 25, 121.534635, 182.000000, 4766
1705846576252, 50, 16, 2, 14, 213.256348, 312.000000, 239
1705846576556, 50, 56, 9, 47, 62.396763, 93.000000, 14207
1705846590823, 50, 115, 19, 96, 32.385190, 49.000000, 135202
1705846726088, 50, 118, 19, 99, 33.542903, 51.000000, 140152
1705846866361, 50, 112, 18, 94, 34.579520, 51.000000, 101990
1705846968433, 50, 33, 5, 28, 104.609612, 153.000000, 2412
1705846977359, 50, 78, 13, 65, 46.093550, 69.000000, 53643
1705847031373, 50, 72, 12, 60, 47.788628, 71.000000, 40896
1705847072335, 50, 28, 4, 24, 123.998326, 178.000000, 1046
1705847073444, 50, 30, 5, 25, 123.750000, 185.000000, 2199
1705847075705, 50, 78, 13, 65, 47.366787, 70.000000, 36179
1705847111940, 50, 38, 6, 32, 97.568462, 141.000000, 3689
1705847115683, 50, 38, 6, 32, 93.398437, 140.000000, 3697
1705847119435, 50, 52, 8, 44, 67.008413, 100.000000, 11800
1705847131299, 50, 100, 16, 84, 33.947656, 51.000000, 69476
1705847200835, 50, 54, 9, 45, 63.250868, 93.000000, 11914
1705847215708, 50, 24, 4, 20, 152.411702, 228.000000, 2368
1705847218416, 50, 67, 11, 56, 48.161147, 73.000000, 34117
1705847252608, 50, 79, 13, 66, 44.355073, 67.000000, 51896
1705847304563, 50, 44, 7, 37, 78.632102, 117.000000, 7191
1705847311805, 50, 42, 7, 35, 83.392485, 124.000000, 8388
1705847320247, 50, 63, 10, 53, 53.979415, 80.000000, 17998
1705847338302, 50, 92, 15, 77, 38.694039, 58.000000, 66028
1705847404394, 50, 90, 15, 75, 36.746528, 55.000000, 53279
1705847457727, 50, 67, 11, 56, 54.694146, 82.000000, 26873
1705847484663, 50, 111, 18, 93, 30.316019, 45.000000, 98120
1705847586525, 50, 68, 11, 57, 47.665671, 71.000000, 41759
1705847628653, 50, 48, 8, 40, 71.983236, 105.000000, 14233
1705847642969, 50, 33, 5, 28, 121.334754, 182.000000, 2119
1705847645142, 50, 117, 19, 98, 31.688902, 47.000000, 165886
1705847811095, 50, 20, 3, 17, 172.939551, 257.000000, 907
1705847812061, 50, 15, 2, 13, 230.671875, 337.000000, 135
1705847812257, 50, 46, 7, 39, 84.230639, 123.000000, 4951
1705847817261, 50, 28, 4, 24, 123.415179, 184.000000, 917
1705847818232, 50, 116, 19, 97, 29.275593, 43.000000, 183229
1705848001521, 50, 111, 18, 93, 31.488387, 47.000000, 124573
1705848130014, 50, 33, 5, 28, 111.463068, 163.000000, 3535
1705848133921, 50, 102, 17, 85, 36.629136, 54.000000, 81083
1705848215076, 50, 96, 16, 80, 38.107829, 56.000000, 78735
1705848293880, 50, 27, 4, 23, 151.830440, 221.000000, 1210
1705848295143, 50, 78, 13, 65, 48.934295, 71.000000, 43771
1705848338978, 50, 60, 10, 50, 61.205729, 91.000000, 17187
1705848356229, 50, 81, 13, 68, 41.874035, 62.000000, 38158
1705848394450, 50, 45, 7, 38, 73.460069, 108.000000, 5633
1705848400147, 50, 64, 10, 54, 57.241211, 85.000000, 18159
1705848418358, 50, 49, 8, 41, 71.552934, 101.000000, 8729
1705848429911, 50, 73, 12, 61, 48.933473, 73.000000, 78451
1705848508708, 50, 97, 16, 81, 38.700870, 58.000000, 91514
1705848600286, 50, 74, 12, 62, 49.790752, 74.000000, 34380
1705848634721, 50, 48, 8, 40, 75.930990, 113.000000, 8664
1705848643440, 50, 48, 8, 40, 71.219076, 102.000000, 8481
1705848651977, 50, 57, 9, 48, 62.265625, 92.000000, 13498
1705848665537, 50, 36, 6, 30, 93.556858, 137.000000, 3263
1705848668859, 50, 55, 9, 46, 69.394602, 103.000000, 13131
1705848682046, 50, 19, 3, 16, 185.625000, 277.000000, 414
1705848682513, 50, 38, 6, 32, 92.890625, 139.000000, 3386
1705848688281, 50, 99, 16, 83, 36.676057, 53.000000, 123336
1705848811971, 50, 32, 5, 27, 116.247314, 174.000000, 2246
1705848814269, 50, 64, 10, 54, 54.597168, 81.000000, 18407
1705848832729, 50, 100, 16, 84, 35.491406, 53.000000, 69002
1705848901783, 50, 80, 13, 67, 49.028711, 73.000000, 37834
1705848939673, 50, 39, 6, 33, 90.745994, 136.000000, 3294
1705848943031, 50, 52, 8, 44, 69.251803, 102.000000, 9215
1705848952307, 50, 49, 8, 41, 68.441167, 102.000000, 10155
1705848962524, 50, 74, 12, 62, 47.981313, 71.000000, 34559
1705848997150, 50, 42, 7, 35, 90.582217, 135.000000, 5232
1705849005889, 50, 13, 2, 11, 267.986779, 392.000000, 284
1705849006539, 50, 94, 15, 79, 40.490442, 60.000000, 73527
1705849080121, 50, 91, 15, 76, 38.730254, 59.000000, 64669
1705849144844, 50, 62, 10, 52, 55.951361, 82.000000, 17049
1705849161947, 50, 44, 7, 37, 82.479759, 123.000000, 7005
1705849169008, 50, 103, 17, 86, 38.734337, 58.000000, 109546
1705849278622, 50, 117, 19, 98, 29.847289, 45.000000, 155171
1705849433866, 50, 40, 6, 34, 90.843164, 133.000000, 6537
1705849440468, 50, 40, 6, 34, 84.980469, 126.000000, 4102
1705849444624, 50, 90, 15, 75, 35.690972, 53.000000, 54881
1705849501838, 50, 67, 11, 56, 48.967176, 73.000000, 48540
1705849550757, 50, 96, 16, 80, 34.622854, 51.000000, 131024
1705849681843, 50, 33, 5, 28, 106.373224, 159.000000, 2984
1705849684879, 50, 67, 11, 56, 46.731066, 70.000000, 40784
1705849725719, 50, 97, 16, 81, 37.591656, 54.000000, 65744
1705849791526, 50, 114, 19, 95, 30.040005, 45.000000, 213948
1705850005573, 50, 104, 17, 87, 36.079177, 52.000000, 95052
1705850100692, 50, 117, 19, 98, 33.989717, 50.000000, 128862
1705850229760, 50, 80, 13, 67, 44.920898, 67.000000, 37916
1705850267731, 50, 96, 16, 80, 40.721029, 60.000000, 76929
1705850346992, 50, 115, 19, 96, 31.450408, 47.000000, 213344
1705850560722, 50, 105, 17, 88, 37.501190, 57.000000, 123474
1705850684254, 50, 64, 10, 54, 55.622681, 83.000000, 21264
1705850705581, 50, 63, 10, 53, 59.374256, 89.000000, 24494
1705850730136, 50, 91, 15, 76, 42.265024, 63.000000, 65271
1705850795460, 50, 51, 8, 43, 67.507506, 99.000000, 9966
1705850805490, 50, 44, 7, 37, 80.385121, 120.000000, 6813
1705850812360, 50, 111, 18, 93, 34.553491, 49.000000, 91892
1705850904305, 50, 40, 6, 34, 86.093750, 126.000000, 3455
1705850907821, 50, 100, 16, 84, 39.001562, 59.000000, 65964
1705850976731, 50, 85, 14, 71, 38.908088, 58.000000, 65598
1705851042708, 50, 45, 7, 38, 75.656597, 113.000000, 9603
1705851052368, 50, 109, 18, 91, 30.422771, 45.000000, 138730
1705851191176, 50, 94, 15, 79, 35.088098, 53.000000, 54923
1705851246155, 50, 98, 16, 82, 37.200255, 55.000000, 66481
1705851312692, 50, 102, 17, 85, 34.890931, 52.000000, 109446
1705851422207, 50, 87, 14, 73, 43.615661, 65.000000, 45766
1705851468038, 50, 44, 7, 37, 79.331676, 114.000000, 6644
1705851474745, 50, 16, 2, 14, 213.750000, 310.000000, 154
1705851474960, 50, 28, 4, 24, 123.344866, 179.000000, 1215
1705851478736, 50, 64, 10, 54, 54.249268, 80.000000, 26876
1705851505984, 50, 30, 5, 25, 116.660937, 167.000000, 3783
1705851509831, 50, 116, 19, 97, 32.144397, 48.000000, 132174
1705851642063, 50, 14, 2, 12, 241.741071, 362.000000, 144
1705851642257, 50, 49, 8, 41, 78.217474, 117.000000, 9935
1705851652257, 50, 90, 15, 75, 41.486285, 63.000000, 63200
1705851715512, 50, 114, 19, 95, 30.389734, 45.000000, 138626
1705851854219, 50, 92, 15, 77, 38.727497, 59.000000, 67421
1705851921694, 50, 14, 2, 12, 264.828683, 397.000000, 159
1705851921906, 50, 92, 15, 77, 37.238621, 54.000000, 63876
1705851988154, 50, 74, 12, 62, 44.487226, 66.000000, 52652
1705852041176, 50, 27, 4, 23, 130.991319, 196.000000, 2022
1705852043251, 50, 20, 3, 17, 177.465625, 264.000000, 438
1705852043742, 50, 75, 12, 63, 43.525859, 65.000000, 55195
1705852098992, 50, 50, 8, 42, 74.528750, 111.000000, 9441
1705852108500, 50, 20, 3, 17, 175.824219, 261.000000, 466
1705852109021, 50, 103, 17, 86, 33.715261, 51.000000, 83015
1705852192108, 50, 54, 9, 45, 64.687211, 97.000000, 12446
1705852204606, 50, 34, 5, 29, 109.057904, 163.000000, 1927
1705852206585, 50, 81, 13, 68, 46.315966, 69.000000, 76020
1705852285168, 50, 86, 14, 72, 46.123001, 69.000000, 63109
1705852348675, 50, 43, 7, 36, 80.317587, 116.000000, 10545
1705852359285, 50, 44, 7, 37, 78.107422, 115.000000, 7692
1705852367033, 50, 100, 16, 84, 33.432960, 51.000000, 165124
1705852532225, 50, 79, 13, 66, 50.123616, 75.000000, 37730
1705852570009, 50, 112, 18, 94, 30.973075, 47.000000, 104757
1705852674826, 50, 81, 13, 68, 45.639853, 69.000000, 46659
1705852721539, 50, 97, 16, 81, 36.680896, 55.000000, 66312
1705852787917, 50, 58, 9, 49, 57.097252, 85.000000, 13689
1705852801668, 50, 55, 9, 46, 65.242862, 96.000000, 20435
1705852824850, 50, 78, 13, 65, 44.889323, 67.000000, 64475
1705852889694, 50, 14, 2, 12, 271.891741, 406.000000, 234
1705852889982, 50, 79, 13, 66, 44.983485, 67.000000, 57380
1705852947428, 50, 117, 19, 98, 30.816640, 47.000000, 135193
1705853082689, 50, 94, 15, 79, 41.943983, 63.000000, 61388
1705853144131, 50, 66, 11, 55, 57.013494, 85.000000, 22793
1705853166978, 50, 73, 12, 61, 47.174658, 70.000000, 29426
1705853196460, 50, 63, 10, 53, 57.254464, 85.000000, 21863
1705853218387, 50, 103, 17, 86, 37.968522, 57.000000, 94995
1705853313437, 50, 45, 7, 38, 80.947917, 120.000000, 5612
1705853322076, 50, 115, 19, 96, 33.663043, 50.000000, 187473
1705853509897, 50, 69, 11, 58, 52.179801, 77.000000, 35777
1705853545733, 50, 80, 13, 67, 41.850778, 62.000000, 122756
1705853668548, 50, 25, 4, 21, 140.224688, 206.000000, 2288
1705853670889, 50, 19, 3, 16, 187.927632, 281.000000, 796
1705853671761, 50, 104, 17, 87, 31.385968, 47.000000, 118048
1705853789879, 50, 39, 6, 33, 88.453526, 127.000000, 5739
1705853795669, 50, 76, 12, 64, 51.340255, 77.000000, 44252
1705853839976, 50, 105, 17, 88, 32.741071, 48.000000, 116095
1705853956132, 50, 51, 8, 43, 66.956189, 99.000000, 18570
1705853977656, 50, 105, 17, 88, 32.387649, 48.000000, 117424
1705854095445, 50, 100, 16, 84, 34.875156, 52.000000, 115271
1705854210773, 50, 81, 13, 68, 41.511188, 62.000000, 59761
1705854270589, 50, 96, 16, 80, 35.502380, 53.000000, 104537
1705854375184, 50, 93, 15, 78, 35.481351, 53.000000, 55314
1705854430563, 50, 30, 5, 25, 113.604167, 170.000000, 1711
1705854432329, 50, 28, 4, 24, 134.151507, 198.000000, 1439
1705854433822, 50, 40, 6, 34, 86.761719, 130.000000, 3339
1705854437225, 50, 102, 17, 85, 30.953585, 47.000000, 75112
1705854512402, 50, 94, 15, 79, 33.966922, 51.000000, 54743
1705854571409, 50, 24, 4, 20, 166.054688, 246.000000, 1748
1705854573525, 50, 110, 18, 92, 30.807528, 47.000000, 100949
1705854674530, 50, 38, 6, 32, 93.113281, 139.000000, 3907
1705854678500, 50, 79, 13, 66, 51.351859, 76.000000, 36709
1705854715265, 50, 57, 9, 48, 59.375000, 89.000000, 13048
1705854728377, 50, 109, 18, 91, 32.630949, 48.000000, 111187
1705854839634, 50, 105, 17, 88, 31.101190, 47.000000, 81437
1705854921131, 50, 31, 5, 26, 121.585938, 182.000000, 1982
1705854923176, 50, 115, 19, 96, 35.780435, 53.000000, 121822
1705855045062, 50, 69, 11, 58, 50.855978, 77.000000, 29115
1705855076104, 50, 60, 10, 50, 64.979753, 96.000000, 33414
1705855109908, 50, 108, 18, 90, 34.771412, 53.000000, 120907
1705855230874, 50, 81, 13, 68, 41.837384, 63.000000, 40331
1705855271271, 50, 46, 7, 39, 73.541101, 110.000000, 6430
1705855277764, 50, 26, 4, 22, 142.126502, 211.000000, 1131
1705855278959, 50, 72, 12, 60, 48.694227, 73.000000, 35121
1705855314144, 50, 58, 9, 49, 60.394935, 90.000000, 16191
1705855330387, 50, 61, 10, 51, 58.091461, 87.000000, 31933
1705855362377, 50, 88, 14, 74, 41.397283, 63.000000, 55843
1705855418285, 50, 48, 8, 40, 75.381999, 113.000000, 11081
1705855432204, 50, 19, 3, 16, 176.911184, 264.000000, 956
1705855433526, 50, 110, 18, 92, 30.409322, 45.000000, 155680
1705855589274, 50, 48, 8, 40, 78.652507, 117.000000, 10097
1705855599426, 50, 21, 3, 18, 174.133929, 259.000000, 523
1705855600002, 50, 97, 16, 81, 38.908505, 58.000000, 66724
1705855666780, 50, 57, 9, 48, 63.155565, 95.000000, 15515
1705855682356, 50, 42, 7, 35, 87.507440, 129.000000, 5296
1705855687713, 50, 12, 2, 10, 294.602214, 437.000000, 129
1705855687904, 50, 88, 14, 74, 44.986683, 67.000000, 46014
1705855733983, 50, 86, 14, 72, 42.270167, 62.000000, 44356
1705855780975, 50, 52, 8, 44, 69.493051, 101.000000, 18410
1705855799729, 50, 15, 2, 13, 214.442708, 296.000000, 214
1705855800004, 50, 84, 14, 70, 42.195964, 62.000000, 56035
1705855856105, 50, 96, 16, 80, 36.103841, 53.000000, 77577
1705855933746, 50, 24, 4, 20, 166.338542, 248.000000, 838
1705855934645, 50, 94, 15, 79, 37.330452, 55.000000, 55871
1705855990588, 50, 108, 18, 90, 32.534071, 47.000000, 113792
1705856104442, 50, 44, 7, 37, 82.821378, 121.000000, 8002
1705856112497, 50, 79, 13, 66, 45.984375, 69.000000, 38652
1705856151205, 50, 68, 11, 57, 57.541360, 87.000000, 23702
1705856177691, 50, 21, 3, 18, 160.648810, 238.000000, 1028
1705856179055, 50, 27, 4, 23, 139.586227, 202.000000, 1364
1705856180471, 50, 116, 19, 97, 27.857304, 41.000000, 262897
1705856443440, 50, 63, 10, 53, 58.948537, 88.000000, 21888
1705856465383, 50, 68, 11, 57, 52.869945, 79.000000, 21722
1705856487165, 50, 16, 2, 14, 209.389648, 311.000000, 144
1705856487363, 50, 105, 17, 88, 33.235863, 48.000000, 79352
1705856566772, 50, 84, 14, 70, 44.660296, 66.000000, 77284
1705856644110, 50, 21, 3, 18, 165.755208, 245.000000, 392
1705856644554, 50, 104, 17, 87, 36.223145, 54.000000, 106949
1705856753933, 50, 49, 8, 41, 79.183434, 118.000000, 15590
1705856769900, 50, 88, 14, 74, 37.888816, 56.000000, 84788
1705856854752, 50, 110, 18, 92, 32.236364, 48.000000, 117758
1705856972584, 50, 38, 6, 32, 95.778372, 141.000000, 3251
1705856975895, 50, 18, 3, 15, 201.273600, 300.000000, 639
1705856976586, 50, 37, 6, 31, 95.842483, 137.000000, 3121
1705856979761, 50, 96, 16, 80, 35.129924, 52.000000, 91085
1705857070904, 50, 79, 13, 66, 48.256428, 73.000000, 43896
1705857114854, 50, 100, 16, 84, 34.182578, 51.000000, 81957
1705857196875, 50, 90, 15, 75, 39.218750, 59.000000, 65974
1705857265314, 50, 68, 11, 57, 55.881549, 83.000000, 37353
1705857302996, 50, 81, 13, 68, 42.911796, 65.000000, 53243
1705857356304, 50, 111, 18, 93, 29.352442, 44.000000, 157083
1705857513456, 50, 116, 19, 97, 31.939655, 47.000000, 129433
1705857642947, 50, 28, 4, 24, 127.046735, 190.000000, 1662
1705857644661, 50, 30, 5, 25, 121.124219, 181.000000, 1911
1705857646624, 50, 46, 7, 39, 77.689198, 112.000000, 6654
1705857653330, 50, 38, 6, 32, 91.898232, 137.000000, 3547
1705857656939, 50, 105, 17, 88, 28.468452, 43.000000, 91729
1705857748722, 50, 16, 2, 14, 211.813477, 305.000000, 290
1705857751516, 50, 37, 6, 31, 92.343750, 138.000000, 6000
1705857757895, 50, 37, 6, 31, 103.338260, 155.000000, 4454
1705857762414, 50, 42, 7, 35, 85.124814, 127.000000, 7479
1705857769949, 50, 55, 9, 46, 68.268617, 102.000000, 26963
1705857796973, 50, 45, 7, 38, 76.713715, 112.000000, 8212
1705857805269, 50, 100, 16, 84, 38.137969, 54.000000, 82671
1705857888005, 50, 19, 3, 16, 184.258840, 276.000000, 546
1705857888617, 50, 105, 17, 88, 31.470164, 47.000000, 97008
1705857985689, 50, 55, 9, 46, 66.886364, 98.000000, 12569
1705857998323, 50, 106, 17, 89, 30.905808, 46.000000, 81580
1705858082501, 50, 75, 12, 63, 47.796875, 71.000000, 44083
1705858126955, 50, 63, 10, 53, 60.023438, 91.000000, 30790
1705858157809, 50, 96, 16, 80, 39.579915, 59.000000, 66343
1705858224216, 50, 110, 18, 92, 30.686080, 47.000000, 97109
1705858321382, 50, 110, 18, 92, 32.810014, 49.000000, 116360
1705858437800, 50, 112, 18, 94, 32.814837, 49.000000, 154221
1705858592080, 50, 20, 3, 17, 188.842773, 276.000000, 839
1705858592971, 50, 22, 3, 19, 145.468750, 213.000000, 436
1705858593462, 50, 111, 18, 93, 33.049761, 47.000000, 137985
1705858731512, 50, 109, 18, 91, 32.411124, 49.000000, 99395
1705858833518, 50, 114, 19, 95, 31.492873, 46.000000, 177163
1705859011031, 50, 97, 16, 81, 36.239691, 55.000000, 102208
1705859113296, 50, 75, 12, 63, 49.934375, 74.000000, 34904
1705859148264, 50, 39, 6, 33, 81.145833, 117.000000, 3146
1705859151463, 50, 109, 18, 91, 34.508314, 47.000000, 91232
1705859242753, 50, 87, 14, 73, 40.835848, 61.000000, 47167
1705859289981, 50, 102, 17, 85, 34.840150, 49.000000, 92646
1705859382691, 50, 60, 10, 50, 54.828711, 83.000000, 25871
1705859408892, 50, 57, 9, 48, 65.703125, 99.000000, 11450
1705859420393, 50, 80, 13, 67, 47.362842, 71.000000, 57365
1705859480298, 50, 49, 8, 41, 74.157685, 110.000000, 13896
1705859494575, 50, 110, 18, 92, 32.560653, 49.000000, 100002
1705859594653, 50, 115, 19, 96, 30.339606, 45.000000, 151355
1705859746064, 50, 32, 5, 27, 109.562012, 158.000000, 3524
1705859749658, 50, 68, 11, 57, 56.353401, 84.000000, 23989
1705859773702, 50, 62, 10, 52, 57.699093, 87.000000, 17146
1705859790912, 50, 20, 3, 17, 155.250000, 226.000000, 528
1705859791498, 50, 40, 6, 34, 81.269531, 121.000000, 3054
1705859794609, 50, 14, 2, 12, 237.455357, 352.000000, 150
1705859794822, 50, 48, 8, 40, 77.113444, 112.000000, 7158
1705859804146, 50, 81, 13, 68, 45.861280, 69.000000, 89680
1705859894191, 50, 21, 3, 18, 176.151786, 262.000000, 641
1705859894885, 50, 63, 10, 53, 58.582093, 87.000000, 22169
1705859917117, 50, 112, 18, 94, 31.492606, 46.000000, 102596
1705860019771, 50, 27, 4, 23, 136.232639, 203.000000, 1068
1705860020892, 50, 80, 13, 67, 42.508789, 63.000000, 39121
1705860060077, 50, 36, 6, 30, 92.685764, 137.000000, 4407
1705860064538, 50, 55, 9, 46, 58.295455, 87.000000, 12933
1705860077526, 50, 81, 13, 68, 42.808642, 64.000000, 37536
1705860115127, 50, 118, 19, 99, 30.101827, 45.000000, 209051
1705860326587, 50, 79, 13, 66, 44.769185, 67.000000, 63358
1705860390309, 50, 56, 9, 47, 54.603795, 81.000000, 18572
1705860408946, 50, 42, 7, 35, 91.603795, 134.000000, 6489
1705860415489, 50, 82, 13, 69, 41.929878, 63.000000, 62690
1705860478240, 50, 79, 13, 66, 45.207674, 67.000000, 36740
1705860515033, 50, 12, 2, 10, 294.524740, 428.000000, 173
1705860515262, 50, 108, 18, 90, 32.793692, 48.000000, 94670
1705860609997, 50, 94, 15, 79, 38.356549, 57.000000, 57538
1705860667586, 50, 74, 12, 62, 50.581081, 75.000000, 34252
1705860701902, 50, 84, 14, 70, 42.322359, 63.000000, 44022
1705860748579, 50, 64, 10, 54, 55.766968, 83.000000, 30472
1705860779417, 50, 64, 10, 54, 55.269241, 83.000000, 34962
1705860814433, 50, 85, 14, 71, 40.251011, 61.000000, 55882
1705860870383, 50, 98, 16, 82, 37.298709, 54.000000, 80128
1705860950572, 50, 32, 5, 27, 107.106934, 160.000000, 2166
1705860952800, 50, 93, 15, 78, 41.845598, 63.000000, 56044
1705861008899, 50, 104, 17, 87, 36.633564, 55.000000, 78838
1705861087800, 50, 25, 4, 21, 148.057813, 222.000000, 1247
1705861089107, 50, 25, 4, 21, 135.137500, 201.000000, 870
1705861090040, 50, 82, 13, 69, 42.418064, 63.000000, 45615
1705861138200, 50, 46, 7, 39, 69.626486, 98.000000, 13316
1705861151895, 50, 90, 15, 75, 38.975260, 58.000000, 86612
1705861238573, 50, 31, 5, 26, 121.910786, 180.000000, 1818
1705861240453, 50, 14, 2, 12, 243.945661, 363.000000, 289
1705861240803, 50, 79, 13, 66, 43.717168, 65.000000, 43480
1705861284336, 50, 66, 11, 55, 57.957860, 86.000000, 22527
1705861306926, 50, 31, 5, 26, 119.754284, 179.000000, 2473
1705861309461, 50, 74, 12, 62, 46.879012, 70.000000, 35014
1705861344540, 50, 72, 12, 60, 50.303819, 74.000000, 27406
1705861372007, 50, 93, 15, 78, 37.939348, 56.000000, 53955
1705861429786, 50, 62, 10, 52, 50.444808, 75.000000, 24537
1705861454656, 50, 73, 12, 61, 51.729452, 77.000000, 31053
1705861485764, 50, 43, 7, 36, 92.100291, 138.000000, 6195
1705861492012, 50, 111, 18, 93, 32.021819, 48.000000, 104621
1705861596701, 50, 36, 6, 30, 92.853082, 139.000000, 7701
1705861604469, 50, 90, 15, 75, 35.657986, 53.000000, 54881
1705861659406, 50, 55, 9, 46, 69.921023, 104.000000, 13471
1705861672947, 50, 99, 16, 83, 40.221275, 60.000000, 68756
1705861741764, 50, 50, 8, 42, 72.912500, 107.000000, 8500
1705861750328, 50, 116, 19, 97, 28.951694, 43.000000, 210563
1705861963561, 50, 114, 19, 95, 29.739583, 44.000000, 177634
1705862141533, 50, 60, 10, 50, 55.380599, 83.000000, 31929
1705862173528, 50, 46, 7, 39, 76.800272, 111.000000, 7044
1705862180637, 50, 118, 19, 99, 30.289294, 45.000000, 221079
1705862401783, 50, 57, 9, 48, 61.614583, 93.000000, 15399
1705862417248, 50, 80, 13, 67, 43.380859, 65.000000, 36574
1705862453875, 50, 26, 4, 22, 130.567909, 195.000000, 1009
1705862454937, 50, 108, 18, 90, 35.481771, 51.000000, 97044
1705862552051, 50, 99, 16, 83, 39.464331, 59.000000, 68859
1705862620976, 50, 102, 17, 85, 35.167356, 53.000000, 106794
1705862730853, 50, 57, 9, 48, 62.812500, 94.000000, 17818
1705862749013, 50, 84, 14, 70, 42.214286, 63.000000, 56238
1705862805324, 50, 86, 14, 72, 37.713481, 56.000000, 45457
1705862850840, 50, 14, 2, 12, 252.449777, 374.000000, 136
1705862851029, 50, 12, 2, 10, 288.216146, 426.000000, 164
1705862851246, 50, 94, 15, 79, 34.661735, 50.000000, 56058
1705862907361, 50, 64, 10, 54, 51.697998, 76.000000, 17618
1705862925032, 50, 87, 14, 73, 41.312073, 61.000000, 91271
1705863016360, 50, 30, 5, 25, 130.459375, 195.000000, 1657
1705863018077, 50, 15, 2, 13, 211.550391, 312.000000, 225
1705863020919, 50, 58, 9, 49, 63.034752, 93.000000, 20856
1705863042133, 50, 68, 11, 57, 52.891774, 79.000000, 33043
1705863075232, 50, 115, 19, 96, 31.490557, 47.000000, 158412
1705863233714, 50, 15, 2, 13, 234.245312, 351.000000, 183
1705863233957, 50, 50, 8, 42, 75.141875, 109.000000, 9526
1705863243534, 50, 104, 17, 87, 30.426082, 45.000000, 93465
1705863337051, 50, 96, 16, 80, 38.836670, 56.000000, 78271
1705863415376, 50, 48, 8, 40, 77.249349, 115.000000, 9130
1705863424569, 50, 98, 16, 82, 36.654974, 55.000000, 64998
1705863489630, 50, 38, 6, 32, 84.687500, 127.000000, 3503
1705863495918, 50, 103, 17, 86, 32.814775, 49.000000, 119141
1705863615433, 50, 78, 13, 65, 43.678636, 65.000000, 73233
1705863688731, 50, 106, 17, 89, 33.258402, 48.000000, 84136
1705863772927, 50, 14, 2, 12, 240.256696, 344.000000, 137
1705863773118, 50, 73, 12, 61, 50.082406, 70.000000, 28721
1705863801902, 50, 74, 12, 62, 52.452914, 79.000000, 35665
1705863837620, 50, 111, 18, 93, 31.857791, 47.000000, 161317
1705863998996, 50, 36, 6, 30, 101.720920, 148.000000, 3213
1705864002260, 50, 30, 5, 25, 124.441667, 186.000000, 3233
1705864005547, 50, 68, 11, 57, 55.445772, 79.000000, 24483
1705864032367, 50, 100, 16, 84, 36.174219, 51.000000, 89588
1705864122339, 50, 70, 11, 59, 47.542411, 71.000000, 22799
1705864145190, 50, 103, 17, 86, 33.578580, 49.000000, 77107
1705864222361, 50, 58, 9, 49, 58.248922, 87.000000, 13421
1705864235842, 50, 100, 16, 84, 35.442031, 51.000000, 65650
1705864301554, 50, 20, 3, 17, 177.679688, 258.000000, 363
1705864301982, 50, 28, 4, 24, 121.158203, 178.000000, 1601
1705864303636, 50, 103, 17, 86, 36.592385, 55.000000, 75350
1705864379043, 50, 12, 2, 10, 293.505208, 430.000000, 109
1705864379203, 50, 85, 14, 71, 41.035731, 61.000000, 76825
1705864458656, 50, 72, 12, 60, 51.499566, 77.000000, 42330
1705864501445, 50, 38, 6, 32, 92.600894, 136.000000, 8332
1705864509835, 50, 98, 16, 82, 35.705566, 51.000000, 122185
1705864632077, 50, 56, 9, 47, 70.595006, 102.000000, 15527
1705864647659, 50, 43, 7, 36, 82.751453, 119.000000, 6740
1705864654461, 50, 37, 6, 31, 98.891470, 148.000000, 3289
1705864657812, 50, 63, 10, 53, 53.484623, 81.000000, 17592
1705864675494, 50, 34, 5, 29, 101.487592, 152.000000, 2356
1705864677903, 50, 13, 2, 11, 304.335337, 447.000000, 124
1705864678079, 50, 98, 16, 82, 38.366629, 57.000000, 81015
1705864761834, 50, 86, 14, 72, 39.042515, 59.000000, 64838
1705864827077, 50, 85, 14, 71, 40.793026, 61.000000, 121136
1705864948278, 50, 103, 17, 86, 28.713592, 43.000000, 105882
1705865054226, 50, 52, 8, 44, 69.679988, 104.000000, 9380
1705865063673, 50, 51, 8, 43, 69.998468, 99.000000, 9078
1705865072803, 50, 25, 4, 21, 139.746875, 209.000000, 1046
1705865073901, 50, 93, 15, 78, 41.058216, 61.000000, 66705
1705865140660, 50, 103, 17, 86, 30.902306, 46.000000, 108565
1705865249283, 50, 14, 2, 12, 261.064732, 385.000000, 137
1705865249473, 50, 98, 16, 82, 39.017857, 59.000000, 66106
1705865318867, 50, 33, 5, 28, 108.433949, 162.000000, 3983
1705865323219, 50, 75, 12, 63, 42.211354, 63.000000, 38751
1705865362029, 50, 93, 15, 78, 38.823295, 59.000000, 82312
1705865444399, 50, 117, 19, 98, 32.605502, 49.000000, 136787
1705865581256, 50, 40, 6, 34, 79.970703, 118.000000, 5651
1705865586958, 50, 61, 10, 51, 68.934682, 99.000000, 18258
1705865605280, 50, 68, 11, 57, 50.947495, 77.000000, 28857
1705865634202, 50, 115, 19, 96, 31.900272, 47.000000, 132309
1705865766580, 50, 109, 18, 91, 33.196316, 49.000000, 140111
1705865906752, 50, 108, 18, 90, 32.816696, 49.000000, 97176
1705866006742, 50, 98, 16, 82, 33.778599, 51.000000, 177036
1705866184150, 50, 50, 8, 42, 71.767148, 107.000000, 13624
1705866197827, 50, 63, 10, 53, 58.728671, 88.000000, 21891
1705866219771, 50, 22, 3, 19, 162.808949, 244.000000, 446
1705866220269, 50, 24, 4, 20, 147.942383, 220.000000, 983
1705866221303, 50, 25, 4, 21, 133.356250, 199.000000, 838
1705866222204, 50, 88, 14, 74, 40.886763, 61.000000, 66993
1705866289250, 50, 60, 10, 50, 57.201823, 85.000000, 19923
1705866309237, 50, 28, 4, 24, 116.128104, 174.000000, 1846
1705866311142, 50, 97, 16, 81, 38.102388, 57.000000, 132142
1705866445816, 50, 32, 5, 27, 107.199707, 160.000000, 3359
1705866449541, 50, 28, 4, 24, 144.279018, 216.000000, 1151
1705866450756, 50, 51, 8, 43, 67.087929, 99.000000, 10471
1705866461282, 50, 84, 14, 70, 48.214658, 73.000000, 47579
1705866508965, 50, 110, 18, 92, 32.282209, 48.000000, 132279
1705866641301, 50, 96, 16, 80, 40.677612, 61.000000, 90898
1705866732268, 50, 114, 19, 95, 30.911458, 47.000000, 126404
1705866858736, 50, 78, 13, 65, 43.065905, 65.000000, 37987
1705866896776, 50, 12, 2, 10, 322.600260, 483.000000, 110
1705866896938, 50, 39, 6, 33, 96.290064, 144.000000, 4917
1705866904121, 50, 16, 2, 14, 237.053711, 353.000000, 345
1705866904825, 50, 55, 9, 46, 62.613636, 93.000000, 14601
1705866919480, 50, 31, 5, 26, 112.781250, 167.000000, 2605
1705866922136, 50, 66, 11, 55, 54.562027, 81.000000, 24200
1705866946401, 50, 33, 5, 28, 111.926847, 167.000000, 2813
1705866949274, 50, 69, 11, 58, 55.028533, 82.000000, 34713
1705866984048, 50, 63, 10, 53, 67.773562, 99.000000, 18574
1705867002688, 50, 117, 19, 98, 26.537210, 39.000000, 218256
1705867221004, 50, 116, 19, 97, 29.366304, 43.000000, 271265
1705867492336, 50, 60, 10, 50, 59.201823, 88.000000, 17749
1705867512499, 50, 116, 19, 97, 31.192551, 47.000000, 223950
1705867736816, 50, 104, 17, 87, 33.127254, 49.000000, 115635
1705867852516, 50, 76, 12, 64, 45.178454, 67.000000, 61027
1705867913608, 50, 55, 9, 46, 68.558239, 101.000000, 23023
1705867936690, 50, 103, 17, 86, 34.890018, 53.000000, 111699
1705868048445, 50, 52, 8, 44, 68.481070, 100.000000, 13385
1705868061886, 50, 45, 7, 38, 86.707986, 130.000000, 9222
1705868071446, 50, 67, 11, 56, 52.772854, 79.000000, 35807
1705868107313, 50, 49, 8, 41, 75.127551, 108.000000, 12565
1705868119942, 50, 63, 10, 53, 53.437500, 80.000000, 23962
1705868146554, 50, 90, 15, 75, 38.672830, 58.000000, 115487
1705868262408, 50, 48, 8, 40, 78.059896, 114.000000, 13470
1705868275932, 50, 33, 5, 28, 107.844697, 160.000000, 4992
1705868280984, 50, 118, 19, 99, 33.234905, 49.000000, 192354
1705868473396, 50, 12, 2, 10, 308.255208, 459.000000, 205
1705868473655, 50, 117, 19, 98, 30.626335, 45.000000, 191334
1705868665059, 50, 48, 8, 40, 77.465820, 114.000000, 15324
1705868680451, 50, 25, 4, 21, 132.359375, 191.000000, 2097
1705868682616, 50, 74, 12, 62, 44.362437, 66.000000, 54396
1705868737069, 50, 36, 6, 30, 103.328993, 154.000000, 5520
1705868745089, 50, 70, 11, 59, 48.656362, 73.000000, 43754
1705868789219, 50, 61, 10, 51, 54.573642, 81.000000, 31929
1705868821212, 50, 45, 7, 38, 76.918924, 115.000000, 10513
1705868831778, 50, 21, 3, 18, 170.835938, 256.000000, 550
1705868832382, 50, 22, 3, 19, 156.399148, 230.000000, 453
1705868832891, 50, 94, 15, 79, 35.610746, 53.000000, 79876
1705868912824, 50, 92, 15, 77, 38.287194, 56.000000, 53320
1705868966199, 50, 31, 5, 26, 124.453503, 186.000000, 2495
1705868968755, 50, 88, 14, 74, 34.798473, 52.000000, 45908
1705869014721, 50, 81, 13, 68, 47.824942, 71.000000, 44419
1705869061671, 50, 34, 5, 29, 102.619256, 153.000000, 4075
1705869066073, 50, 93, 15, 78, 33.917171, 51.000000, 58919
1705869125053, 50, 63, 10, 53, 59.422123, 89.000000, 18350
1705869143459, 50, 52, 8, 44, 66.594050, 99.000000, 11992
1705869155514, 50, 49, 8, 41, 69.129464, 98.000000, 8531
1705869164106, 50, 106, 17, 89, 36.777860, 54.000000, 87849
1705869252017, 50, 109, 18, 91, 31.741399, 47.000000, 117346
1705869369443, 50, 25, 4, 21, 143.545469, 213.000000, 1352
1705869370856, 50, 117, 19, 98, 32.044071, 49.000000, 157681
1705869528593, 50, 45, 7, 38, 85.598958, 127.000000, 7708
1705869538106, 50, 39, 6, 33, 92.541066, 138.000000, 6025
1705869544494, 50, 32, 5, 27, 113.554688, 167.000000, 2318
1705869546862, 50, 87, 14, 73, 41.204203, 61.000000, 48346
1705869595269, 50, 15, 2, 13, 221.105469, 329.000000, 197
1705869595518, 50, 14, 2, 12, 256.583705, 379.000000, 169
1705869595775, 50, 74, 12, 62, 53.867188, 81.000000, 35918
1705869631757, 50, 98, 16, 82, 39.748645, 59.000000, 80300
1705869712114, 50, 75, 12, 63, 45.026042, 67.000000, 29871
1705869742040, 50, 102, 17, 85, 33.934819, 51.000000, 90847
1705869832951, 50, 108, 18, 90, 33.127306, 49.000000, 177097
1705870013066, 50, 37, 6, 31, 92.676520, 136.000000, 6284
1705870019713, 50, 32, 5, 27, 102.607422, 153.000000, 1796
1705870021561, 50, 24, 4, 20, 145.530599, 216.000000, 958
1705870022570, 50, 44, 7, 37, 76.113636, 112.000000, 8139
1705870030774, 50, 63, 10, 53, 58.715278, 86.000000, 17969
1705870048811, 50, 58, 9, 49, 62.756600, 94.000000, 16717
1705870065590, 50, 93, 15, 78, 35.178091, 53.000000, 54615
1705870120268, 50, 72, 12, 60, 48.365885, 72.000000, 26967
1705870147288, 50, 54, 9, 45, 58.624204, 87.000000, 16865
1705870164204, 50, 14, 2, 12, 272.276786, 395.000000, 205
1705870166977, 50, 18, 3, 15, 185.262153, 273.000000, 771
1705870168089, 50, 110, 18, 92, 35.471982, 48.000000, 144302
1705870312486, 50, 52, 8, 44, 70.878906, 101.000000, 9524
1705870322072, 50, 36, 6, 30, 108.974175, 163.000000, 3672
1705870325806, 50, 67, 11, 56, 58.798974, 88.000000, 22247
1705870348107, 50, 82, 13, 69, 42.286681, 63.000000, 45086
1705870393259, 50, 90, 15, 75, 38.117448, 57.000000, 65663
1705870458985, 50, 105, 17, 88, 31.441713, 45.000000, 142698
1705870601746, 50, 60, 10, 50, 59.920833, 89.000000, 20236
1705870622046, 50, 22, 3, 19, 169.156960, 251.000000, 594
1705870625525, 50, 55, 9, 46, 60.178480, 90.000000, 22957
1705870648852, 50, 100, 16, 84, 36.322656, 52.000000, 70979
1705870719885, 50, 106, 17, 89, 32.628243, 49.000000, 80798
1705870800758, 50, 106, 17, 89, 31.984080, 47.000000, 82794
1705870883612, 50, 81, 13, 68, 46.368465, 69.000000, 61467
1705870945133, 50, 33, 5, 28, 94.316643, 140.000000, 2700
1705870947885, 50, 106, 17, 89, 33.846551, 50.000000, 80647
1705871028589, 50, 114, 19, 95, 31.324356, 46.000000, 190866
1705871219516, 50, 32, 5, 27, 112.905273, 169.000000, 3784
1705871223362, 50, 45, 7, 38, 79.403472, 119.000000, 6553
1705871231920, 50, 94, 15, 79, 39.241190, 58.000000, 82138
1705871314437, 50, 98, 16, 82, 36.488361, 55.000000, 92058
1705871406551, 50, 24, 4, 20, 154.996419, 229.000000, 1016
1705871407621, 50, 36, 6, 30, 90.959201, 136.000000, 2997
1705871410671, 50, 36, 6, 30, 108.589410, 162.000000, 3922
1705871414649, 50, 13, 2, 11, 261.285457, 382.000000, 152
1705871414854, 50, 87, 14, 73, 45.913254, 69.000000, 45926
1705871460846, 50, 85, 14, 71, 38.960478, 58.000000, 44254
1705871505153, 50, 55, 9, 46, 65.219460, 97.000000, 17320
1705871522528, 50, 66, 11, 55, 57.225142, 85.000000, 27131
1705871552325, 50, 56, 9, 47, 60.331072, 90.000000, 36058
1705871588759, 50, 64, 10, 54, 57.113647, 85.000000, 24199
1705871613010, 50, 44, 7, 37, 83.959606, 125.000000, 10882
1705871623952, 50, 28, 4, 24, 122.960100, 182.000000, 1270
1705871625275, 50, 100, 16, 84, 32.788477, 49.000000, 97358
1705871722694, 50, 87, 14, 73, 35.115392, 50.000000, 55141
1705871777896, 50, 105, 17, 88, 34.680208, 52.000000, 97975
1705871875925, 50, 73, 12, 61, 46.015625, 69.000000, 29214
1705871905191, 50, 61, 10, 51, 61.759221, 93.000000, 18305
1705871923558, 50, 15, 2, 13, 223.779688, 332.000000, 173
1705871926467, 50, 116, 19, 97, 27.691272, 41.000000, 188525
1705872115365, 50, 61, 10, 51, 59.061219, 88.000000, 36157
1705872151589, 50, 111, 18, 93, 28.769250, 42.000000, 282850
1705872434504, 50, 111, 18, 93, 32.509150, 49.000000, 142954
1705872577515, 50, 93, 15, 78, 34.332157, 50.000000, 79704
1705872657280, 50, 42, 7, 35, 79.298363, 118.000000, 10136
1705872667468, 50, 90, 15, 75, 37.922917, 56.000000, 78569
1705872746093, 50, 60, 10, 50, 56.514128, 81.000000, 37869
1705872784022, 50, 87, 14, 73, 39.122665, 59.000000, 66828
1705872850911, 50, 51, 8, 43, 66.321691, 99.000000, 12945
1705872866515, 50, 31, 5, 26, 113.779738, 170.000000, 3407
1705872870250, 50, 16, 2, 14, 213.641113, 320.000000, 215
1705872870515, 50, 16, 2, 14, 208.446777, 308.000000, 192
1705872870759, 50, 13, 2, 11, 271.108774, 392.000000, 166
1705872870977, 50, 22, 3, 19, 176.168324, 263.000000, 474
1705872871502, 50, 73, 12, 61, 48.028682, 73.000000, 30348
1705872901922, 50, 102, 17, 85, 33.919730, 50.000000, 94481
1705872996465, 50, 22, 3, 19, 146.894531, 219.000000, 667
1705872997196, 50, 19, 3, 16, 183.117958, 273.000000, 702
1705872997962, 50, 80, 13, 67, 43.121094, 65.000000, 36044
1705873036879, 50, 116, 19, 97, 25.595316, 38.000000, 298456
1705873335721, 50, 76, 12, 64, 48.661647, 72.000000, 65171
1705873400962, 50, 80, 13, 67, 46.114160, 69.000000, 65802
1705873466828, 50, 67, 11, 56, 58.868820, 88.000000, 46988
1705873513882, 50, 63, 10, 53, 54.670061, 83.000000, 58368
1705873572312, 50, 50, 8, 42, 67.231582, 99.000000, 23820
1705873596194, 50, 69, 11, 58, 51.257473, 77.000000, 41377
1705873637625, 50, 81, 13, 68, 42.575540, 63.000000, 138702
1705873776391, 50, 110, 18, 92, 30.823224, 46.000000, 166069
1705873942519, 50, 40, 6, 34, 85.341016, 125.000000, 7124
1705873952446, 50, 14, 2, 12, 245.920201, 362.000000, 317
1705873953111, 50, 49, 8, 41, 65.827487, 99.000000, 10447
1705873963614, 50, 57, 9, 48, 52.490132, 78.000000, 17187
1705873980854, 50, 57, 9, 48, 60.617462, 90.000000, 17383
1705873998320, 50, 76, 12, 64, 49.062500, 73.000000, 31203
1705874029579, 50, 54, 9, 45, 67.181424, 100.000000, 17816
1705874047451, 50, 98, 16, 82, 35.524075, 53.000000, 79935
1705874127443, 50, 64, 10, 54, 54.504395, 81.000000, 17956
1705874145451, 50, 61, 10, 51, 58.484375, 87.000000, 20640
1705874166157, 50, 49, 8, 41, 71.916454, 101.000000, 8935
1705874177651, 50, 70, 11, 59, 50.102623, 75.000000, 51229
1705874229350, 50, 118, 19, 99, 30.379370, 45.000000, 188166
1705874417582, 50, 112, 18, 94, 33.337193, 49.000000, 165502
1705874583149, 50, 100, 16, 84, 34.521172, 51.000000, 82115
1705874665319, 50, 45, 7, 38, 77.089931, 115.000000, 7040
1705874672410, 50, 46, 7, 39, 71.733696, 107.000000, 7397
1705874679871, 50, 24, 4, 20, 157.042318, 233.000000, 834
1705874680765, 50, 72, 12, 60, 48.991062, 73.000000, 56550
1705874737370, 50, 100, 16, 84, 37.587969, 56.000000, 66316
1705874803742, 50, 24, 4, 20, 152.197266, 222.000000, 1044
1705874807898, 50, 16, 2, 14, 214.695557, 304.000000, 419
1705874808684, 50, 43, 7, 36, 83.453125, 125.000000, 7311
1705874816046, 50, 49, 8, 41, 78.448023, 117.000000, 10192
1705874826300, 50, 100, 16, 84, 33.505391, 51.000000, 82820
1705874909184, 50, 15, 2, 13, 244.795833, 367.000000, 139
1705874909376, 50, 69, 11, 58, 49.517663, 74.000000, 27966
1705874937402, 50, 14, 2, 12, 266.807478, 400.000000, 173
1705874937625, 50, 24, 4, 20, 154.996419, 228.000000, 1045
1705874938722, 50, 30, 5, 25, 131.282031, 196.000000, 2239
1705874941022, 50, 55, 9, 46, 66.506126, 97.000000, 22632
1705874966340, 50, 52, 8, 44, 68.192308, 102.000000, 14786
1705874981509, 50, 117, 19, 98, 27.834669, 41.000000, 164773
1705875146343, 50, 90, 15, 75, 37.767795, 55.000000, 79245
1705875225647, 50, 15, 2, 13, 220.906771, 324.000000, 170
1705875225873, 50, 39, 6, 33, 93.211939, 139.000000, 4193
1705875230121, 50, 67, 11, 56, 58.465485, 87.000000, 20522
1705875250705, 50, 15, 2, 13, 240.077865, 360.000000, 199
1705875250956, 50, 58, 9, 49, 59.091325, 89.000000, 16714
1705875267725, 50, 114, 19, 95, 33.320244, 49.000000, 195211
1705875462997, 50, 68, 11, 57, 51.603860, 77.000000, 30059
1705875495561, 50, 62, 10, 52, 58.509199, 87.000000, 31987
1705875527900, 50, 96, 16, 80, 39.011230, 59.000000, 80217
1705875608179, 50, 102, 17, 85, 32.546645, 49.000000, 90315
1705875698549, 50, 103, 17, 86, 39.998635, 59.000000, 78119
1705875776723, 50, 49, 8, 41, 68.159758, 97.000000, 8133
1705875784909, 50, 72, 12, 60, 54.138455, 81.000000, 27996
1705875812958, 50, 21, 3, 18, 175.013393, 260.000000, 551
1705875813569, 50, 112, 18, 94, 32.550223, 49.000000, 96905
1705875910537, 50, 30, 5, 25, 126.031250, 189.000000, 1701
1705875912303, 50, 94, 15, 79, 38.056848, 55.000000, 55852
1705875970782, 50, 86, 14, 72, 42.091570, 63.000000, 80540
1705876051701, 50, 94, 15, 79, 34.547041, 51.000000, 99284
1705876151048, 50, 116, 19, 97, 31.453394, 47.000000, 173537
1705876324656, 50, 114, 19, 95, 32.564762, 48.000000, 164655
1705876489381, 50, 51, 8, 43, 68.543199, 102.000000, 10487
1705876499923, 50, 82, 13, 69, 42.931212, 63.000000, 36653
1705876536631, 50, 39, 6, 33, 93.422075, 139.000000, 4598
1705876541282, 50, 58, 9, 49, 57.967403, 84.000000, 9804
1705876551140, 50, 54, 9, 45, 66.027199, 98.000000, 8771
1705876559966, 50, 36, 6, 30, 95.618490, 141.000000, 2615
1705876564558, 50, 74, 12, 62, 51.537796, 77.000000, 46775
1705876611705, 50, 36, 6, 30, 101.278863, 149.000000, 4852
1705876616615, 50, 78, 13, 65, 45.722356, 68.000000, 37924
1705876654611, 50, 68, 11, 57, 47.843836, 71.000000, 37528
1705876692194, 50, 24, 4, 20, 170.326172, 251.000000, 1087
1705876693343, 50, 79, 13, 66, 44.671776, 67.000000, 44844
1705876738245, 50, 91, 15, 76, 38.071772, 56.000000, 55107
1705876793407, 50, 93, 15, 78, 37.450521, 56.000000, 66757
1705876860220, 50, 31, 5, 26, 116.469884, 174.000000, 2567
1705876862840, 50, 110, 18, 92, 30.759961, 46.000000, 156075
1705877021472, 50, 22, 3, 19, 168.764205, 249.000000, 1003
1705877022814, 50, 61, 10, 51, 57.525615, 87.000000, 21966
1705877044844, 50, 98, 16, 82, 33.913425, 50.000000, 69501
1705877114414, 50, 93, 15, 78, 37.500168, 57.000000, 66158
1705877180635, 50, 86, 14, 72, 38.369368, 57.000000, 45105
1705877225796, 50, 110, 18, 92, 30.915971, 47.000000, 173203
1705877399059, 50, 73, 12, 61, 51.099101, 77.000000, 29078
1705877428198, 50, 118, 19, 99, 32.450742, 48.000000, 163542
1705877591801, 50, 28, 4, 24, 135.717913, 203.000000, 3621
1705877595475, 50, 38, 6, 32, 90.116160, 131.000000, 4954
1705877602354, 50, 67, 11, 56, 55.104769, 83.000000, 42175
1705877644905, 50, 69, 11, 58, 52.576993, 79.000000, 24491
1705877669457, 50, 21, 3, 18, 161.310268, 240.000000, 435
1705877669946, 50, 42, 7, 35, 85.811012, 127.000000, 6452
1705877676451, 50, 13, 2, 11, 265.246394, 379.000000, 121
1705877676623, 50, 13, 2, 11, 305.667067, 455.000000, 120
1705877676796, 50, 66, 11, 55, 57.248461, 85.000000, 27065
1705877703920, 50, 49, 8, 41, 72.901307, 109.000000, 10902
1705877714878, 50, 87, 14, 73, 45.455819, 68.000000, 46231
1705877761177, 50, 109, 18, 91, 33.255447, 49.000000, 98456
1705877862222, 50, 40, 6, 34, 92.699219, 139.000000, 5428
1705877868010, 50, 115, 19, 96, 31.370109, 47.000000, 157520
1705878025599, 50, 46, 7, 39, 80.285326, 120.000000, 7208
1705878032871, 50, 15, 2, 13, 222.755208, 332.000000, 139
1705878033074, 50, 97, 16, 81, 35.701514, 51.000000, 63917
1705878097045, 50, 66, 11, 55, 55.987157, 83.000000, 30240
1705878127341, 50, 49, 8, 41, 77.399554, 116.000000, 8472
1705878135871, 50, 36, 6, 30, 102.604167, 152.000000, 3686
1705878139621, 50, 108, 18, 90, 32.747830, 49.000000, 115171
1705878254848, 50, 115, 19, 96, 32.893444, 49.000000, 176560
1705878434168, 50, 97, 16, 81, 38.555896, 57.000000, 124297
1705878558833, 50, 16, 2, 14, 232.476563, 341.000000, 319
1705878559204, 50, 112, 18, 94, 31.048410, 47.000000, 210290
1705878769557, 50, 112, 18, 94, 32.908517, 49.000000, 208267
1705878977884, 50, 79, 13, 66, 47.448230, 71.000000, 76560
1705879054496, 50, 104, 17, 87, 31.343149, 47.000000, 114436
1705879168989, 50, 16, 2, 14, 209.667969, 296.000000, 351
1705879169392, 50, 27, 4, 23, 132.929398, 199.000000, 2035
1705879171488, 50, 44, 7, 37, 83.298295, 124.000000, 9266
1705879180807, 50, 74, 12, 62, 56.249155, 85.000000, 44708
1705879228306, 50, 74, 12, 62, 49.091427, 73.000000, 43428
1705879272093, 50, 34, 5, 29, 98.228401, 145.000000, 4410
1705879276558, 50, 55, 9, 46, 64.347159, 96.000000, 19371
1705879295981, 50, 58, 9, 49, 63.546606, 90.000000, 13992
1705879310039, 50, 46, 7, 39, 82.005265, 121.000000, 7796
1705879317892, 50, 21, 3, 18, 173.883836, 256.000000, 679
1705879318624, 50, 37, 6, 31, 105.639780, 158.000000, 3609
1705879322293, 50, 105, 17, 88, 32.444196, 48.000000, 82030
1705879404377, 50, 46, 7, 39, 85.028872, 127.000000, 6246
1705879410675, 50, 105, 17, 88, 33.404985, 49.000000, 96677
1705879512367, 50, 28, 4, 24, 119.280134, 176.000000, 2032
1705879514765, 50, 32, 5, 27, 113.703863, 169.000000, 9437
1705879524266, 50, 21, 3, 18, 177.488839, 265.000000, 453
1705879524779, 50, 102, 17, 85, 37.752604, 56.000000, 86421
1705879611260, 50, 100, 16, 84, 34.617578, 51.000000, 96538
1705879707851, 50, 104, 17, 87, 31.418495, 46.000000, 110200
1705879818125, 50, 109, 18, 91, 33.156250, 49.000000, 100200
1705879918385, 50, 58, 9, 49, 54.896282, 83.000000, 13084
1705879931530, 50, 84, 14, 70, 39.246094, 59.000000, 52370
1705879983959, 50, 112, 18, 94, 29.448940, 45.000000, 102066
1705880090007, 50, 82, 13, 69, 39.978087, 59.000000, 66866
1705880157228, 50, 24, 4, 20, 154.932292, 224.000000, 1439
1705880158732, 50, 105, 17, 88, 36.722619, 55.000000, 83375
1705880242165, 50, 80, 13, 67, 39.716748, 59.000000, 61598
1705880303821, 50, 33, 5, 28, 111.013258, 166.000000, 1939
1705880305813, 50, 42, 7, 35, 84.644717, 126.000000, 4906
1705880310774, 50, 90, 15, 75, 41.442708, 63.000000, 53913
1705880364739, 50, 87, 14, 73, 37.467672, 55.000000, 44355
1705880409166, 50, 118, 19, 99, 27.624470, 40.000000, 137428
1705880546707, 50, 19, 3, 16, 203.906250, 304.000000, 1804
1705880553174, 50, 102, 17, 85, 37.836091, 56.000000, 103180
1705880656718, 50, 90, 15, 75, 40.256879, 58.000000, 85830
1705880742609, 50, 76, 12, 64, 47.304688, 70.000000, 29665
1705880772328, 50, 25, 4, 21, 157.368750, 235.000000, 921
1705880773311, 50, 92, 15, 77, 39.630859, 59.000000, 66078
1705880839443, 50, 52, 8, 44, 67.422776, 97.000000, 10954
1705880850461, 50, 50, 8, 42, 73.652422, 101.000000, 11862
1705880862384, 50, 20, 3, 17, 185.769531, 269.000000, 451
1705880862886, 50, 93, 15, 78, 39.705323, 59.000000, 175876
1705881038831, 50, 118, 19, 99, 29.659560, 45.000000, 163708
1705881205123, 50, 102, 17, 85, 34.286152, 49.000000, 122133
1705881327656, 50, 21, 3, 18, 162.715774, 242.000000, 824
1705881328535, 50, 81, 13, 68, 41.190683, 61.000000, 80088
1705881408687, 50, 21, 3, 18, 159.183036, 229.000000, 904
1705881409643, 50, 24, 4, 20, 154.984375, 224.000000, 1804
1705881411499, 50, 40, 6, 34, 92.574609, 138.000000, 7930
1705881419485, 50, 80, 13, 67, 47.611328, 71.000000, 56622
1705881476162, 50, 75, 12, 63, 51.366250, 77.000000, 45038
1705881521264, 50, 14, 2, 12, 243.128627, 360.000000, 327
1705881521653, 50, 67, 11, 56, 57.982509, 87.000000, 35014
1705881559322, 50, 31, 5, 26, 117.074093, 171.000000, 3166
1705881562833, 50, 94, 15, 79, 38.592088, 57.000000, 64373
1705881627264, 50, 58, 9, 49, 60.910560, 91.000000, 14011
1705881641345, 50, 25, 4, 21, 129.949062, 192.000000, 1313
1705881642725, 50, 22, 3, 19, 155.724432, 232.000000, 496
1705881643274, 50, 106, 17, 89, 35.451024, 52.000000, 120270
1705881763614, 50, 37, 6, 31, 106.146115, 159.000000, 3801
1705881767479, 50, 108, 18, 90, 34.429398, 47.000000, 114944
1705881882489, 50, 51, 8, 43, 72.559743, 106.000000, 9251
1705881891803, 50, 108, 18, 90, 34.472150, 51.000000, 115230
1705882010053, 50, 118, 19, 99, 29.258226, 43.000000, 331052
1705882341469, 50, 112, 18, 94, 33.318917, 48.000000, 164446
1705882506127, 50, 34, 5, 29, 110.847886, 166.000000, 2851
1705882509034, 50, 99, 16, 83, 36.644413, 54.000000, 99244
1705882608349, 50, 14, 2, 12, 239.873884, 337.000000, 160
1705882608563, 50, 70, 11, 59, 51.189732, 76.000000, 24350
1705882632985, 50, 84, 14, 70, 43.733817, 65.000000, 46459
1705882679500, 50, 100, 16, 84, 34.704688, 52.000000, 70228
1705882749800, 50, 88, 14, 74, 37.767223, 56.000000, 47231
1705882797085, 50, 112, 18, 94, 30.681501, 46.000000, 104434
1705882905036, 50, 62, 10, 52, 50.253276, 75.000000, 25495
1705882930910, 50, 38, 6, 32, 98.580856, 147.000000, 8761
1705882939727, 50, 20, 3, 17, 182.225000, 273.000000, 507
1705882940288, 50, 85, 14, 71, 44.614706, 67.000000, 56841
1705882997197, 50, 81, 13, 68, 46.953680, 71.000000, 61844
1705883059105, 50, 98, 16, 82, 39.972098, 59.000000, 67763
1705883126924, 50, 88, 14, 74, 41.613104, 63.000000, 46962
1705883173940, 50, 30, 5, 25, 127.904687, 188.000000, 1676
1705883175669, 50, 118, 19, 99, 29.108845, 43.000000, 138892
1705883314629, 50, 48, 8, 40, 70.569661, 105.000000, 11237
1705883328352, 50, 81, 13, 68, 47.482639, 71.000000, 72029
1705883400748, 50, 67, 11, 56, 57.499534, 87.000000, 35234
1705883436050, 50, 45, 7, 38, 76.269097, 114.000000, 7569
1705883443671, 50, 46, 7, 39, 75.815557, 113.000000, 8433
1705883452173, 50, 57, 9, 48, 57.863350, 86.000000, 16265
1705883468492, 50, 116, 19, 97, 33.093481, 49.000000, 139821
1705883608379, 50, 22, 3, 19, 179.249157, 261.000000, 956
1705883609388, 50, 31, 5, 26, 117.733115, 176.000000, 2776
1705883612215, 50, 28, 4, 24, 116.947545, 171.000000, 977
1705883613246, 50, 42, 7, 35, 87.159319, 125.000000, 7060
1705883623119, 50, 108, 18, 90, 32.175203, 48.000000, 149815
1705883773317, 50, 34, 5, 29, 107.597426, 161.000000, 3840
1705883777213, 50, 48, 8, 40, 79.135579, 116.000000, 21547
1705883798815, 50, 82, 13, 69, 43.806974, 65.000000, 69408
1705883868275, 50, 21, 3, 18, 155.445313, 233.000000, 970
1705883869308, 50, 33, 5, 28, 110.923295, 166.000000, 3541
1705883872904, 50, 25, 4, 21, 139.192813, 206.000000, 1956
1705883874913, 50, 80, 13, 67, 42.972656, 62.000000, 55626
1705883930603, 50, 19, 3, 16, 187.197677, 277.000000, 1124
1705883931788, 50, 111, 18, 93, 33.193834, 49.000000, 171080
1705884106656, 50, 80, 13, 67, 42.657227, 63.000000, 56764
1705884163762, 50, 110, 18, 92, 33.654830, 50.000000, 108171
1705884271999, 50, 73, 12, 61, 50.794092, 77.000000, 29116
1705884301181, 50, 19, 3, 16, 210.739309, 316.000000, 373
1705884301614, 50, 33, 5, 28, 112.715909, 169.000000, 1902
1705884303575, 50, 44, 7, 37, 84.137074, 123.000000, 5766
1705884310056, 50, 114, 19, 95, 31.172766, 47.000000, 149976
1705884460100, 50, 62, 10, 52, 60.165071, 89.000000, 20487
1705884480645, 50, 66, 11, 55, 58.123165, 87.000000, 31356
1705884512065, 50, 55, 9, 46, 67.165057, 99.000000, 13055
1705884527615, 50, 100, 16, 84, 36.497266, 55.000000, 157372
1705884685354, 50, 88, 14, 74, 39.788263, 58.000000, 86457
1705884771869, 50, 30, 5, 25, 142.892188, 212.000000, 3218
1705884775139, 50, 85, 14, 71, 44.854504, 66.000000, 94926
1705884870121, 50, 104, 17, 87, 32.157527, 49.000000, 141229
1705885011400, 50, 99, 16, 83, 35.755997, 52.000000, 120383
1705885131836, 50, 111, 18, 93, 30.423001, 45.000000, 137184
1705885269073, 50, 115, 19, 96, 29.001291, 43.000000, 214560
1705885483692, 50, 50, 8, 42, 72.170313, 108.000000, 16867
1705885500613, 50, 90, 15, 75, 42.956597, 65.000000, 83359
1705885586406, 50, 80, 13, 67, 44.791016, 66.000000, 51756
1705885638531, 50, 12, 2, 10, 292.293620, 437.000000, 302
1705885638886, 50, 18, 3, 15, 200.847656, 295.000000, 420
1705885639356, 50, 64, 10, 54, 54.873169, 83.000000, 26347
1705885665759, 50, 50, 8, 42, 67.103125, 99.000000, 11303
1705885677118, 50, 114, 19, 95, 31.575452, 47.000000, 166967
1705885844423, 50, 46, 7, 39, 77.671535, 116.000000, 8995
1705885853481, 50, 96, 16, 80, 39.765299, 59.000000, 105090
1705885958632, 50, 20, 3, 17, 202.842187, 304.000000, 482
1705885959177, 50, 39, 6, 33, 87.007212, 130.000000, 3779
1705885965121, 50, 91, 15, 76, 39.728108, 58.000000, 97669
1705886063156, 50, 50, 8, 42, 69.646875, 104.000000, 13844
1705886077055, 50, 115, 19, 96, 31.316576, 46.000000, 213846
1705886290967, 50, 48, 8, 40, 73.971191, 105.000000, 17471
1705886308494, 50, 42, 7, 35, 88.643973, 132.000000, 11584
1705886320129, 50, 69, 11, 58, 45.628397, 69.000000, 34728
1705886354921, 50, 86, 14, 72, 42.878997, 64.000000, 80044
1705886435023, 50, 64, 10, 54, 51.396484, 77.000000, 25710
1705886460797, 50, 88, 14, 74, 37.062322, 54.000000, 67376
1705886528225, 50, 92, 15, 77, 37.851563, 57.000000, 79050
1705886609388, 50, 38, 6, 32, 90.789474, 136.000000, 7227
1705886616984, 50, 118, 19, 99, 30.937765, 47.000000, 162412
1705886779456, 50, 13, 2, 11, 242.866587, 360.000000, 124
1705886779632, 50, 57, 9, 48, 65.207648, 97.000000, 16610
1705886796321, 50, 92, 15, 77, 36.818954, 54.000000, 54273
1705886850651, 50, 62, 10, 52, 63.949597, 95.000000, 17475
1705886868204, 50, 110, 18, 92, 35.216548, 51.000000, 115132
1705886983396, 50, 56, 9, 47, 63.377511, 95.000000, 12754
1705886996307, 50, 57, 9, 48, 64.427083, 94.000000, 12774
1705887009136, 50, 86, 14, 72, 43.326399, 65.000000, 53588
1705887065659, 50, 72, 12, 60, 49.222568, 73.000000, 94237
1705887160270, 50, 50, 8, 42, 66.618750, 97.000000, 9471
1705887169800, 50, 38, 6, 32, 91.412212, 133.000000, 4054
1705887173907, 50, 103, 17, 86, 35.555901, 51.000000, 113149
1705887287115, 50, 16, 2, 14, 239.182617, 350.000000, 157
1705887287324, 50, 105, 17, 88, 33.670275, 50.000000, 112482
1705887399861, 50, 63, 10, 53, 58.918015, 88.000000, 36047
1705887435972, 50, 94, 15, 79, 36.130319, 54.000000, 55951
1705887491995, 50, 55, 9, 46, 62.883523, 95.000000, 12483
1705887504529, 50, 51, 8, 43, 67.960172, 98.000000, 10655
1705887517622, 50, 69, 11, 58, 54.513134, 81.000000, 34313
1705887552306, 50, 110, 18, 92, 30.510653, 45.000000, 145062
1705887697429, 50, 64, 10, 54, 53.066406, 79.000000, 18355
1705887715847, 50, 93, 15, 78, 37.715894, 57.000000, 54427
1705887770329, 50, 57, 9, 48, 61.171875, 91.000000, 13223
1705887783616, 50, 105, 17, 88, 38.312202, 57.000000, 80609
1705887864305, 50, 19, 3, 16, 191.248766, 282.000000, 438
1705887864804, 50, 110, 18, 92, 30.901989, 47.000000, 94435
1705887959294, 50, 52, 8, 44, 62.539213, 93.000000, 10570
1705887969917, 50, 33, 5, 28, 114.341856, 171.000000, 2008
1705887974287, 50, 82, 13, 69, 40.331555, 60.000000, 54705
1705888029343, 50, 12, 2, 10, 285.752604, 409.000000, 320
1705888029724, 50, 36, 6, 30, 99.301649, 148.000000, 3937
1705888033724, 50, 60, 10, 50, 57.432682, 86.000000, 21350
1705888055133, 50, 97, 16, 81, 35.221327, 53.000000, 66588
1705888121774, 50, 20, 3, 17, 155.859375, 215.000000, 401
1705888122229, 50, 44, 7, 37, 83.529830, 125.000000, 5959
1705888128240, 50, 104, 17, 87, 34.697266, 51.000000, 80905
1705888209208, 50, 62, 10, 52, 60.544733, 90.000000, 21927
1705888231188, 50, 48, 8, 40, 85.336507, 128.000000, 13697
1705888247969, 50, 78, 13, 65, 42.742388, 64.000000, 49393
1705888297691, 50, 30, 5, 25, 123.747396, 184.000000, 3129
1705888300877, 50, 73, 12, 61, 51.505886, 76.000000, 38581
1705888339511, 50, 118, 19, 99, 30.608614, 45.000000, 241262
1705888580840, 50, 104, 17, 87, 33.814979, 49.000000, 96523
1705888677422, 50, 24, 4, 20, 146.149089, 211.000000, 936
1705888678413, 50, 108, 18, 90, 33.920718, 50.000000, 93445
1705888771930, 50, 33, 5, 28, 108.913648, 163.000000, 3786
1705888775769, 50, 16, 2, 14, 229.478516, 342.000000, 212
1705888776032, 50, 94, 15, 79, 35.846077, 52.000000, 55334
1705888833990, 50, 34, 5, 29, 107.643842, 158.000000, 4340
1705888838681, 50, 86, 14, 72, 40.009084, 60.000000, 47494
1705888886247, 50, 114, 19, 95, 31.080729, 46.000000, 119201
1705889005515, 50, 85, 14, 71, 46.224816, 69.000000, 46096
1705889051666, 50, 55, 9, 46, 64.122443, 97.000000, 20325
1705889072042, 50, 70, 11, 59, 45.294643, 67.000000, 23990
1705889096088, 50, 25, 4, 21, 138.345000, 201.000000, 1256
1705889097397, 50, 44, 7, 37, 83.564098, 125.000000, 7577
1705889105028, 50, 57, 9, 48, 62.216557, 93.000000, 18225
1705889123311, 50, 22, 3, 19, 168.110795, 249.000000, 615
1705889125966, 50, 88, 14, 74, 40.868963, 61.000000, 96748
1705889223091, 50, 117, 19, 98, 29.839744, 45.000000, 159748
1705889382905, 50, 58, 9, 49, 59.705011, 89.000000, 18819
1705889401788, 50, 108, 18, 90, 31.900318, 47.000000, 100830
1705889502675, 50, 46, 7, 39, 75.046026, 112.000000, 7628
1705889510355, 50, 62, 10, 52, 58.608493, 87.000000, 20810
1705889531233, 50, 50, 8, 42, 61.162344, 91.000000, 10998
1705889542294, 50, 104, 17, 87, 35.960787, 53.000000, 95024
1705889637377, 50, 49, 8, 41, 72.566167, 106.000000, 11864
1705889649306, 50, 85, 14, 71, 42.016544, 62.000000, 43971
