1705839873218, 50, 73, 12, 61, 48.864586, 73.000000, 5144
1705839878756, 50, 93, 15, 78, 35.289819, 52.000000, 1699
1705839880520, 50, 64, 10, 54, 58.343887, 87.000000, 2296
1705839882885, 50, 74, 12, 62, 46.015625, 69.000000, 1571
1705839884513, 50, 67, 11, 56, 53.407766, 79.000000, 1865
1705839886431, 50, 37, 6, 31, 92.392314, 136.000000, 428
1705839886915, 50, 51, 8, 43, 66.476716, 99.000000, 844
1705839887812, 50, 117, 19, 98, 28.124065, 42.000000, 2737
1705839890601, 50, 21, 3, 18, 129.281878, 190.000000, 131
1705839890784, 50, 86, 14, 72, 45.026526, 67.000000, 2267
1705839895127, 50, 106, 17, 89, 32.305793, 49.000000, 6309
1705839901845, 50, 80, 13, 67, 42.789156, 65.000000, 4640
1705839906552, 50, 87, 14, 73, 42.103089, 63.000000, 3222
1705839909828, 50, 16, 2, 14, 164.185303, 245.000000, 69
1705839909952, 50, 84, 14, 70, 41.316499, 61.000000, 2588
1705839912599, 50, 58, 9, 49, 64.295663, 97.000000, 1025
1705839913678, 50, 44, 7, 37, 74.286222, 110.000000, 456
1705839914190, 50, 40, 6, 34, 89.289990, 133.000000, 657
1705839914900, 50, 55, 9, 46, 61.338636, 91.000000, 1070
1705839916023, 50, 90, 15, 75, 40.589410, 58.000000, 1971
1705839920217, 50, 37, 6, 31, 78.647804, 117.000000, 879
1705839921471, 50, 104, 17, 87, 35.334510, 53.000000, 6486
1705839928015, 50, 57, 9, 48, 60.401453, 91.000000, 1395
1705839929473, 50, 75, 12, 63, 48.232292, 72.000000, 1906
1705839931442, 50, 72, 12, 60, 47.796441, 71.000000, 2512
1705839934009, 50, 92, 15, 77, 34.488281, 49.000000, 3013
1705839937077, 50, 30, 5, 25, 95.546615, 143.000000, 237
1705839937368, 50, 44, 7, 37, 74.724787, 110.000000, 682
1705839938115, 50, 79, 13, 66, 48.582402, 73.000000, 3029
1705839941207, 50, 97, 16, 81, 31.753383, 47.000000, 2153
1705839945918, 50, 64, 10, 54, 53.722900, 81.000000, 2508
1705839948790, 50, 24, 4, 20, 122.554687, 177.000000, 132
1705839948984, 50, 72, 12, 60, 45.167209, 67.000000, 2155
1705839951202, 50, 72, 12, 60, 55.781467, 83.000000, 3138
1705839954402, 50, 116, 19, 97, 31.619747, 47.000000, 3676
1705839958134, 50, 116, 19, 97, 30.476091, 45.000000, 2405
1705839960602, 50, 58, 9, 49, 59.118332, 88.000000, 1080
1705839961735, 50, 51, 8, 43, 73.956801, 109.000000, 816
1705839962603, 50, 91, 15, 76, 38.814818, 59.000000, 2787
1705839965442, 50, 44, 7, 37, 75.736861, 113.000000, 622
1705839968077, 50, 112, 18, 94, 32.307129, 48.000000, 5553
1705839974001, 50, 64, 10, 54, 57.347412, 87.000000, 1699
1705839975761, 50, 102, 17, 85, 32.452512, 48.000000, 3424
1705839979248, 50, 99, 16, 83, 34.605429, 51.000000, 3205
1705839982517, 50, 110, 18, 92, 30.456676, 45.000000, 2674
1705839985246, 50, 28, 4, 24, 99.589286, 147.000000, 140
1705839985440, 50, 26, 4, 22, 119.747596, 176.000000, 106
1705839985598, 50, 18, 3, 15, 147.138672, 218.000000, 78
1705839985729, 50, 33, 5, 28, 87.213068, 129.000000, 222
1705839986002, 50, 74, 12, 62, 47.794130, 71.000000, 1655
1705839989781, 50, 45, 7, 38, 69.633681, 104.000000, 1226
1705839991386, 50, 16, 2, 14, 171.706055, 245.000000, 62
1705839991502, 50, 81, 13, 68, 40.114776, 61.000000, 2146
1705839993702, 50, 16, 2, 14, 165.647461, 241.000000, 43
1705839993797, 50, 99, 16, 83, 36.945036, 55.000000, 4044
1705839997893, 50, 96, 16, 80, 35.856934, 53.000000, 2867
1705840000813, 50, 38, 6, 32, 84.545641, 126.000000, 649
1705840001516, 50, 57, 9, 48, 57.161321, 85.000000, 992
1705840002570, 50, 118, 19, 99, 32.631091, 49.000000, 2989
1705840005613, 50, 58, 9, 49, 61.711005, 92.000000, 1316
1705840009310, 50, 45, 7, 38, 78.342014, 117.000000, 1139
1705840010791, 50, 110, 18, 92, 31.493466, 47.000000, 7260
1705840018111, 50, 63, 10, 53, 58.215650, 87.000000, 1398
1705840019564, 50, 88, 14, 74, 38.598988, 57.000000, 2197
1705840021818, 50, 32, 5, 27, 91.724854, 137.000000, 362
1705840022233, 50, 28, 4, 24, 107.804129, 161.000000, 152
1705840022442, 50, 78, 13, 65, 47.710938, 71.000000, 2632
1705840025137, 50, 74, 12, 62, 49.137458, 73.000000, 2004
1705840027200, 50, 104, 17, 87, 33.992563, 51.000000, 2748
1705840030003, 50, 26, 4, 22, 108.405649, 161.000000, 136
1705840032754, 50, 16, 2, 14, 160.375244, 234.000000, 290
1705840033439, 50, 114, 19, 95, 31.877741, 47.000000, 6765
1705840040261, 50, 114, 19, 95, 32.717928, 49.000000, 4896
1705840045212, 50, 79, 13, 66, 41.710542, 62.000000, 2937
1705840048204, 50, 62, 10, 52, 59.255292, 89.000000, 1337
1705840049599, 50, 81, 13, 68, 43.994743, 65.000000, 3268
1705840052927, 50, 116, 19, 97, 32.553879, 49.000000, 2856
1705840055844, 50, 38, 6, 32, 90.312500, 134.000000, 347
1705840056254, 50, 69, 11, 58, 57.703691, 86.000000, 1931
1705840058239, 50, 85, 14, 71, 41.964154, 63.000000, 2221
1705840062670, 50, 33, 5, 28, 96.860559, 145.000000, 1194
1705840064249, 50, 43, 7, 36, 85.161701, 127.000000, 687
1705840064991, 50, 37, 6, 31, 82.073480, 121.000000, 342
1705840065391, 50, 38, 6, 32, 94.151290, 136.000000, 761
1705840066210, 50, 92, 15, 77, 35.754076, 51.000000, 2461
1705840068730, 50, 82, 13, 69, 50.812691, 76.000000, 2182
1705840070980, 50, 48, 8, 40, 73.233724, 106.000000, 936
1705840071978, 50, 33, 5, 28, 97.653883, 146.000000, 215
1705840072254, 50, 12, 2, 10, 204.520182, 294.000000, 43
1705840072355, 50, 60, 10, 50, 60.228646, 90.000000, 1393
1705840075730, 50, 94, 15, 79, 36.986619, 55.000000, 5761
1705840081906, 50, 87, 14, 73, 43.319864, 65.000000, 2521
1705840084489, 50, 78, 13, 65, 44.055489, 67.000000, 2289
1705840086853, 50, 112, 18, 94, 31.104129, 47.000000, 9584
1705840096501, 50, 58, 9, 49, 55.510506, 83.000000, 725
1705840097284, 50, 76, 12, 64, 49.609735, 75.000000, 2772
1705840100120, 50, 91, 15, 76, 40.958963, 61.000000, 1902
1705840102074, 50, 69, 11, 58, 51.092618, 76.000000, 1253
1705840103379, 50, 26, 4, 22, 110.693510, 165.000000, 118
1705840103549, 50, 64, 10, 54, 54.063721, 80.000000, 1622
1705840107221, 50, 109, 18, 91, 33.012185, 49.000000, 4813
1705840112382, 50, 12, 2, 10, 207.812826, 308.000000, 534
1705840112967, 50, 32, 5, 27, 96.252441, 144.000000, 197
1705840113217, 50, 84, 14, 70, 38.858817, 59.000000, 2299
1705840115570, 50, 79, 13, 66, 47.180578, 71.000000, 2679
1705840118302, 50, 12, 2, 10, 197.546875, 281.000000, 73
1705840118428, 50, 91, 15, 76, 35.618304, 53.000000, 1796
1705840120281, 50, 50, 8, 42, 71.487500, 104.000000, 689
1705840121025, 50, 26, 4, 22, 116.340144, 171.000000, 122
1705840121197, 50, 98, 16, 82, 36.634726, 53.000000, 3944
1705840127047, 50, 60, 10, 50, 62.419531, 92.000000, 2079
1705840129520, 50, 117, 19, 98, 30.453642, 44.000000, 6794
1705840136376, 50, 111, 18, 93, 29.436303, 43.000000, 4286
1705840140716, 50, 87, 14, 73, 40.299928, 61.000000, 2026
1705840142793, 50, 114, 19, 95, 30.297697, 45.000000, 3402
1705840146258, 50, 91, 15, 76, 38.217376, 57.000000, 2713
1705840149025, 50, 117, 19, 98, 31.344493, 47.000000, 5271
1705840154353, 50, 14, 2, 12, 183.850446, 274.000000, 49
1705840154471, 50, 57, 9, 48, 64.192708, 96.000000, 827
1705840155353, 50, 36, 6, 30, 86.341146, 129.000000, 374
1705840157670, 50, 52, 8, 44, 67.689153, 100.000000, 1880
1705840159930, 50, 94, 15, 79, 37.662068, 57.000000, 2525
1705840162508, 50, 49, 8, 41, 65.725128, 98.000000, 1048
1705840163615, 50, 108, 18, 90, 30.795501, 46.000000, 3977
1705840167644, 50, 42, 7, 35, 78.459821, 108.000000, 649
1705840168344, 50, 15, 2, 13, 174.487500, 254.000000, 47
1705840168443, 50, 66, 11, 55, 53.786714, 80.000000, 4727
1705840173238, 50, 25, 4, 21, 120.183750, 176.000000, 131
1705840173431, 50, 103, 17, 86, 36.158222, 55.000000, 2649
1705840176141, 50, 74, 12, 62, 48.085304, 72.000000, 1973
1705840180032, 50, 15, 2, 13, 171.696875, 237.000000, 598
1705840180963, 50, 93, 15, 78, 36.949765, 55.000000, 3445
1705840184469, 50, 96, 16, 80, 40.325033, 61.000000, 3279
1705840187805, 50, 27, 4, 23, 115.453125, 173.000000, 178
1705840188045, 50, 80, 13, 67, 47.325586, 71.000000, 2296
1705840190480, 50, 110, 18, 92, 33.325195, 49.000000, 6663
1705840197211, 50, 49, 8, 41, 74.339923, 111.000000, 700
1705840197962, 50, 66, 11, 55, 57.577296, 87.000000, 1979
1705840199991, 50, 58, 9, 49, 56.073545, 85.000000, 846
1705840200889, 50, 87, 14, 73, 41.255388, 61.000000, 1832
1705840204704, 50, 82, 13, 69, 41.851181, 62.000000, 4339
1705840209420, 50, 43, 7, 36, 74.403161, 111.000000, 1510
1705840210989, 50, 60, 10, 50, 59.920833, 89.000000, 1346
1705840212390, 50, 88, 14, 74, 40.162464, 61.000000, 2389
1705840214840, 50, 80, 13, 67, 46.787500, 70.000000, 2385
1705840217277, 50, 43, 7, 36, 80.223383, 120.000000, 778
1705840218108, 50, 19, 3, 16, 143.430510, 206.000000, 86
1705840218246, 50, 111, 18, 93, 33.619088, 50.000000, 3215
1705840221523, 50, 92, 15, 77, 40.078974, 56.000000, 2550
1705840224139, 50, 16, 2, 14, 176.181152, 260.000000, 44
1705840226086, 50, 88, 14, 74, 40.190518, 61.000000, 4037
1705840230475, 50, 115, 19, 96, 28.254755, 42.000000, 5032
1705840235574, 50, 114, 19, 95, 32.083847, 48.000000, 4284
1705840239911, 50, 62, 10, 52, 59.626260, 89.000000, 1897
1705840241860, 50, 16, 2, 14, 146.783203, 215.000000, 43
1705840241953, 50, 56, 9, 47, 66.505301, 99.000000, 933
1705840242950, 50, 20, 3, 17, 132.628125, 198.000000, 75
1705840243082, 50, 21, 3, 18, 126.654483, 187.000000, 152
1705840243294, 50, 56, 9, 47, 62.052176, 93.000000, 857
1705840244214, 50, 50, 8, 42, 72.734375, 106.000000, 702
1705840246811, 50, 49, 8, 41, 66.736288, 99.000000, 1737
1705840248910, 50, 50, 8, 42, 68.211250, 98.000000, 973
1705840249938, 50, 58, 9, 49, 56.892241, 85.000000, 1423
1705840251421, 50, 27, 4, 23, 116.109375, 174.000000, 113
1705840251598, 50, 86, 14, 72, 37.742823, 56.000000, 2432
1705840254082, 50, 109, 18, 91, 29.976419, 45.000000, 3532
1705840257673, 50, 26, 4, 22, 115.171875, 172.000000, 125
1705840257849, 50, 62, 10, 52, 54.388483, 81.000000, 1439
1705840259340, 50, 72, 12, 60, 47.988824, 71.000000, 1661
1705840261052, 50, 14, 2, 12, 166.493304, 241.000000, 38
1705840262921, 50, 26, 4, 22, 119.066106, 170.000000, 918
1705840264199, 50, 57, 9, 48, 60.271227, 90.000000, 2243
1705840266494, 50, 14, 2, 12, 182.237723, 273.000000, 86
1705840266631, 50, 54, 9, 45, 69.970341, 104.000000, 1225
1705840267910, 50, 69, 11, 58, 49.780344, 74.000000, 1405
1705840269379, 50, 12, 2, 10, 222.607422, 306.000000, 35
1705840269472, 50, 32, 5, 27, 90.812744, 135.000000, 211
1705840269738, 50, 44, 7, 37, 73.476563, 110.000000, 500
1705840270295, 50, 100, 16, 84, 37.272656, 55.000000, 2284
1705840272637, 50, 57, 9, 48, 62.210526, 93.000000, 1184
1705840275614, 50, 82, 13, 69, 38.224657, 57.000000, 2296
1705840278262, 50, 50, 8, 42, 76.440625, 114.000000, 1452
1705840279765, 50, 110, 18, 92, 32.440341, 49.000000, 2914
1705840282731, 50, 104, 17, 87, 32.573918, 49.000000, 4574
1705840287367, 50, 104, 17, 87, 33.726713, 51.000000, 3320
1705840290739, 50, 111, 18, 93, 30.195664, 45.000000, 3127
1705840293919, 50, 78, 13, 65, 47.395232, 71.000000, 2072
1705840296043, 50, 39, 6, 33, 82.637816, 123.000000, 1102
1705840297196, 50, 69, 11, 58, 53.910779, 81.000000, 1364
1705840298611, 50, 73, 12, 61, 50.810146, 77.000000, 1716
1705840302401, 50, 14, 2, 12, 185.705078, 273.000000, 203
1705840302952, 50, 99, 16, 83, 33.166035, 49.000000, 4669
1705840307677, 50, 91, 15, 76, 36.683808, 55.000000, 3378
1705840311130, 50, 28, 4, 24, 97.724330, 140.000000, 170
1705840311362, 50, 58, 9, 49, 62.292565, 93.000000, 1040
1705840312454, 50, 57, 9, 48, 66.666667, 98.000000, 1036
1705840313545, 50, 51, 8, 43, 74.102328, 106.000000, 785
1705840314382, 50, 75, 12, 63, 46.035417, 69.000000, 1564
1705840315997, 50, 69, 11, 58, 52.404891, 79.000000, 1498
1705840317559, 50, 60, 10, 50, 67.103125, 97.000000, 1751
1705840321284, 50, 66, 11, 55, 53.983902, 80.000000, 2825
1705840324450, 50, 32, 5, 27, 99.559814, 145.000000, 400
1705840324902, 50, 32, 5, 27, 101.911621, 151.000000, 240
1705840325195, 50, 112, 18, 94, 28.513881, 42.000000, 2739
1705840327994, 50, 25, 4, 21, 120.588750, 179.000000, 103
1705840328157, 50, 28, 4, 24, 112.595424, 167.000000, 128
1705840328346, 50, 74, 12, 62, 47.339527, 71.000000, 1458
1705840329866, 50, 43, 7, 36, 74.320608, 111.000000, 854
1705840330782, 50, 118, 19, 99, 32.307270, 49.000000, 3933
1705840334768, 50, 100, 16, 84, 31.928906, 47.000000, 2455
1705840339019, 50, 24, 4, 20, 121.078125, 179.000000, 453
1705840339833, 50, 75, 12, 63, 48.172917, 72.000000, 2570
1705840342464, 50, 51, 8, 43, 67.408088, 98.000000, 829
1705840343351, 50, 110, 18, 92, 31.279830, 46.000000, 2577
1705840345985, 50, 102, 17, 85, 33.369332, 51.000000, 3048
1705840349094, 50, 60, 10, 50, 62.134115, 93.000000, 1680
1705840350840, 50, 90, 15, 75, 44.186632, 66.000000, 2784
1705840353682, 50, 74, 12, 62, 52.615076, 75.000000, 1420
1705840355155, 50, 16, 2, 14, 143.822021, 214.000000, 54
1705840355260, 50, 104, 17, 87, 36.944712, 55.000000, 2890
1705840360006, 50, 28, 4, 24, 105.137277, 157.000000, 515
1705840360869, 50, 52, 8, 44, 67.541166, 101.000000, 1247
1705840362192, 50, 64, 10, 54, 61.312500, 91.000000, 1388
1705840363641, 50, 21, 3, 18, 117.240234, 175.000000, 121
1705840363817, 50, 62, 10, 52, 52.948715, 79.000000, 1462
1705840365342, 50, 93, 15, 78, 39.452957, 59.000000, 2840
1705840368236, 50, 20, 3, 17, 131.912109, 186.000000, 75
1705840368362, 50, 55, 9, 46, 60.750994, 91.000000, 1128
1705840369547, 50, 50, 8, 42, 73.628750, 109.000000, 725
1705840370325, 50, 33, 5, 28, 102.704309, 154.000000, 250
1705840372362, 50, 76, 12, 64, 46.475637, 69.000000, 3741
1705840376436, 50, 75, 12, 63, 45.946146, 68.000000, 1803
1705840378296, 50, 34, 5, 29, 90.966797, 136.000000, 598
1705840378946, 50, 114, 19, 95, 31.028646, 47.000000, 2896
1705840381970, 50, 114, 19, 95, 33.076343, 49.000000, 3706
1705840385738, 50, 46, 7, 39, 71.863111, 106.000000, 526
1705840386325, 50, 116, 19, 97, 31.630388, 47.000000, 4775
1705840391165, 50, 91, 15, 76, 38.649596, 57.000000, 4377
1705840395610, 50, 73, 12, 61, 50.509418, 75.000000, 1512
1705840397173, 50, 82, 13, 69, 43.698552, 65.000000, 2031
1705840401168, 50, 109, 18, 91, 31.811927, 47.000000, 6207
1705840407724, 50, 54, 9, 45, 62.303530, 93.000000, 1766
1705840409552, 50, 106, 17, 89, 33.132370, 49.000000, 2723
1705840412334, 50, 15, 2, 13, 156.767448, 233.000000, 52
1705840412438, 50, 13, 2, 11, 216.142127, 324.000000, 46
1705840412534, 50, 37, 6, 31, 77.508446, 116.000000, 418
1705840413005, 50, 102, 17, 85, 31.768536, 47.000000, 3045
1705840416111, 50, 33, 5, 28, 82.778764, 124.000000, 313
1705840416485, 50, 106, 17, 89, 29.939564, 44.000000, 2067
1705840418604, 50, 70, 11, 59, 55.083929, 83.000000, 1448
1705840422092, 50, 51, 8, 43, 67.902880, 98.000000, 1745
1705840424184, 50, 45, 7, 38, 75.439236, 111.000000, 697
1705840424932, 50, 102, 17, 85, 33.704044, 48.000000, 2679
1705840427663, 50, 104, 17, 87, 31.742788, 47.000000, 2538
1705840430253, 50, 52, 8, 44, 65.426683, 99.000000, 764
1705840431070, 50, 99, 16, 83, 36.673217, 55.000000, 3446
1705840434774, 50, 57, 9, 48, 62.210526, 92.000000, 1300
1705840436132, 50, 97, 16, 81, 35.625000, 53.000000, 2932
1705840439118, 50, 103, 17, 86, 33.515701, 51.000000, 2981
1705840442159, 50, 100, 16, 84, 36.475781, 54.000000, 3179
1705840447571, 50, 31, 5, 26, 88.348790, 131.000000, 611
1705840448607, 50, 57, 9, 48, 59.915433, 89.000000, 1805
1705840450466, 50, 117, 19, 98, 29.649973, 45.000000, 5710
1705840456254, 50, 55, 9, 46, 64.961648, 97.000000, 1014
1705840457328, 50, 105, 17, 88, 30.154018, 45.000000, 2921
1705840460309, 50, 16, 2, 14, 169.089844, 253.000000, 57
1705840460429, 50, 69, 11, 58, 56.277174, 84.000000, 1668
1705840462161, 50, 90, 15, 75, 41.199653, 61.000000, 2498
1705840464712, 50, 86, 14, 72, 39.698401, 59.000000, 2731
1705840467498, 50, 81, 13, 68, 43.040702, 64.000000, 2742
1705840473264, 50, 39, 6, 33, 88.415465, 132.000000, 1110
1705840474713, 50, 117, 19, 98, 27.796829, 41.000000, 6690
1705840481466, 50, 87, 14, 73, 39.794860, 59.000000, 3708
1705840485227, 50, 74, 12, 62, 50.541385, 73.000000, 1682
1705840486960, 50, 79, 13, 66, 48.053995, 73.000000, 1650
1705840488672, 50, 13, 2, 11, 204.382212, 306.000000, 38
1705840488768, 50, 73, 12, 61, 47.316460, 70.000000, 2031
1705840490853, 50, 37, 6, 31, 83.465160, 125.000000, 383
1705840491287, 50, 43, 7, 36, 75.496003, 112.000000, 541
1705840491880, 50, 61, 10, 51, 56.476018, 84.000000, 1360
1705840495214, 50, 16, 2, 14, 162.273926, 239.000000, 510
1705840496062, 50, 68, 11, 57, 49.315487, 73.000000, 2562
1705840498677, 50, 19, 3, 16, 126.793997, 190.000000, 83
1705840498812, 50, 85, 14, 71, 45.142831, 67.000000, 3227
1705840502105, 50, 100, 16, 84, 32.674297, 49.000000, 2597
1705840504770, 50, 25, 4, 21, 122.563125, 183.000000, 99
1705840504928, 50, 25, 4, 21, 124.638750, 184.000000, 108
1705840505096, 50, 26, 4, 22, 114.246995, 167.000000, 146
1705840505303, 50, 43, 7, 36, 82.823038, 124.000000, 578
1705840505941, 50, 48, 8, 40, 75.579427, 112.000000, 712
1705840508612, 50, 44, 7, 37, 72.059659, 100.000000, 1365
1705840510330, 50, 40, 6, 34, 86.984375, 130.000000, 785
1705840511168, 50, 82, 13, 69, 43.789063, 65.000000, 2646
1705840513869, 50, 46, 7, 39, 71.056386, 104.000000, 618
1705840514540, 50, 88, 14, 74, 40.785156, 61.000000, 2909
1705840517508, 50, 51, 8, 43, 66.272978, 99.000000, 819
1705840519108, 50, 79, 13, 66, 43.892504, 65.000000, 2203
1705840521372, 50, 92, 15, 77, 39.898522, 59.000000, 2584
1705840524009, 50, 90, 15, 75, 39.502604, 59.000000, 2269
1705840526329, 50, 74, 12, 62, 46.463049, 69.000000, 1910
1705840530399, 50, 97, 16, 81, 36.405445, 55.000000, 4775
1705840535531, 50, 15, 2, 13, 161.885156, 227.000000, 434
1705840536025, 50, 82, 13, 69, 45.215892, 67.000000, 2837
1705840538929, 50, 90, 15, 75, 39.856337, 59.000000, 3586
1705840542576, 50, 102, 17, 85, 34.329810, 49.000000, 1972
1705840544603, 50, 104, 17, 87, 35.653546, 51.000000, 3472
1705840548129, 50, 72, 12, 60, 46.064996, 69.000000, 1764
1705840549945, 50, 31, 5, 26, 99.464781, 149.000000, 317
1705840550313, 50, 42, 7, 35, 72.901786, 109.000000, 559
1705840550936, 50, 88, 14, 74, 40.617898, 60.000000, 2052
1705840555099, 50, 46, 7, 39, 71.440987, 107.000000, 2250
1705840557715, 50, 31, 5, 26, 97.779738, 146.000000, 230
1705840558004, 50, 42, 7, 35, 85.174851, 124.000000, 554
1705840558618, 50, 54, 9, 45, 63.301071, 94.000000, 1183
1705840559864, 50, 45, 7, 38, 74.483333, 111.000000, 570
1705840560493, 50, 58, 9, 49, 54.371363, 81.000000, 1069
1705840561614, 50, 36, 6, 30, 94.622396, 141.000000, 411
1705840562076, 50, 82, 13, 69, 42.098990, 63.000000, 2035
1705840564164, 50, 44, 7, 37, 75.601918, 111.000000, 562
1705840564781, 50, 108, 18, 90, 29.911965, 45.000000, 3451
1705840569992, 50, 99, 16, 83, 35.729956, 53.000000, 4129
1705840574493, 50, 34, 5, 29, 86.210363, 129.000000, 1023
1705840575569, 50, 67, 11, 56, 56.489404, 84.000000, 2672
1705840578308, 50, 26, 4, 22, 121.256611, 181.000000, 114
1705840578482, 50, 68, 11, 57, 50.947495, 76.000000, 1870
1705840580408, 50, 49, 8, 41, 70.644133, 105.000000, 713
1705840581172, 50, 105, 17, 88, 33.688244, 49.000000, 2368
1705840583593, 50, 76, 12, 64, 41.574938, 63.000000, 1397
1705840585042, 50, 58, 9, 49, 61.987877, 92.000000, 828
1705840585926, 50, 49, 8, 41, 63.222258, 94.000000, 674
1705840588803, 50, 114, 19, 95, 30.511239, 45.000000, 6500
1705840595698, 50, 42, 7, 35, 80.580357, 120.000000, 1254
1705840597006, 50, 118, 19, 99, 31.272511, 47.000000, 3671
1705840600731, 50, 86, 14, 72, 38.024164, 57.000000, 2363
1705840603154, 50, 73, 12, 61, 48.429848, 72.000000, 2377
1705840605592, 50, 93, 15, 78, 41.736727, 62.000000, 2400
1705840608062, 50, 61, 10, 51, 58.839652, 89.000000, 1049
1705840609171, 50, 26, 4, 22, 111.715745, 161.000000, 299
1705840609521, 50, 48, 8, 40, 78.146159, 117.000000, 649
1705840610223, 50, 85, 14, 71, 41.719669, 62.000000, 1873
1705840614314, 50, 48, 8, 40, 75.332031, 107.000000, 1487
1705840616181, 50, 55, 9, 46, 60.100231, 91.000000, 1375
1705840617610, 50, 28, 4, 24, 104.278460, 152.000000, 118
1705840617782, 50, 86, 14, 72, 43.158180, 65.000000, 4383
1705840622231, 50, 114, 19, 95, 29.849712, 45.000000, 4382
1705840626677, 50, 116, 19, 97, 30.173761, 45.000000, 2584
1705840629315, 50, 12, 2, 10, 204.798828, 299.000000, 36
1705840629404, 50, 56, 9, 47, 64.331752, 97.000000, 774
1705840630232, 50, 82, 13, 69, 39.136814, 58.000000, 1867
1705840632168, 50, 74, 12, 62, 48.663429, 73.000000, 1363
1705840635557, 50, 62, 10, 52, 58.277974, 87.000000, 3887
1705840639884, 50, 56, 9, 47, 67.212612, 96.000000, 966
1705840640927, 50, 105, 17, 88, 32.246280, 48.000000, 2861
1705840643851, 50, 46, 7, 39, 72.179985, 108.000000, 864
1705840644781, 50, 21, 3, 18, 140.785714, 209.000000, 84
1705840644918, 50, 60, 10, 50, 57.643229, 86.000000, 1084
1705840646059, 50, 37, 6, 31, 73.793285, 110.000000, 493
1705840646607, 50, 30, 5, 25, 100.279688, 147.000000, 201
1705840646865, 50, 44, 7, 37, 83.226207, 121.000000, 518
1705840647435, 50, 109, 18, 91, 31.939077, 47.000000, 2528
1705840651924, 50, 27, 4, 23, 111.421875, 167.000000, 603
1705840652888, 50, 46, 7, 39, 80.666950, 121.000000, 946
1705840653888, 50, 102, 17, 85, 36.409390, 55.000000, 4644
1705840658585, 50, 106, 17, 89, 34.700767, 50.000000, 2191
1705840660828, 50, 28, 4, 24, 97.362723, 146.000000, 121
1705840661002, 50, 75, 12, 63, 47.957187, 71.000000, 2041
1705840663097, 50, 81, 13, 68, 45.012828, 67.000000, 2669
1705840665822, 50, 42, 7, 35, 77.112537, 115.000000, 519
1705840666424, 50, 36, 6, 30, 85.123481, 127.000000, 348
1705840666825, 50, 73, 12, 61, 53.340111, 80.000000, 2114
1705840671158, 50, 73, 12, 61, 49.798159, 74.000000, 3342
1705840674836, 50, 108, 18, 90, 32.241862, 48.000000, 5084
1705840679986, 50, 38, 6, 32, 81.199219, 117.000000, 396
1705840680442, 50, 46, 7, 39, 79.414063, 119.000000, 595
1705840681097, 50, 106, 17, 89, 34.283332, 49.000000, 5483
1705840686661, 50, 16, 2, 14, 147.678223, 220.000000, 54
1705840686777, 50, 84, 14, 70, 36.772600, 55.000000, 2166
1705840689005, 50, 38, 6, 32, 85.507607, 128.000000, 396
1705840689464, 50, 115, 19, 96, 31.089062, 46.000000, 4147
1705840693663, 50, 82, 13, 69, 42.999905, 64.000000, 2250
1705840698064, 50, 110, 18, 92, 31.536222, 47.000000, 6612
1705840705047, 50, 48, 8, 40, 76.847331, 114.000000, 871
1705840705972, 50, 58, 9, 49, 65.789063, 99.000000, 1449
1705840707481, 50, 99, 16, 83, 37.657986, 54.000000, 3304
1705840710837, 50, 85, 14, 71, 40.113051, 61.000000, 1836
1705840712724, 50, 109, 18, 91, 30.978928, 46.000000, 3311
1705840716089, 50, 58, 9, 49, 61.422414, 91.000000, 1016
1705840717161, 50, 67, 11, 56, 50.402285, 75.000000, 1513
1705840718729, 50, 82, 13, 69, 45.109304, 67.000000, 2646
1705840721426, 50, 80, 13, 67, 45.822266, 68.000000, 2392
1705840725752, 50, 67, 11, 56, 49.797341, 75.000000, 2553
1705840728664, 50, 92, 15, 77, 39.931980, 59.000000, 3238
1705840731955, 50, 46, 7, 39, 74.831861, 112.000000, 502
1705840732511, 50, 18, 3, 15, 133.524523, 198.000000, 78
1705840732639, 50, 108, 18, 90, 36.499023, 55.000000, 7179
1705840739881, 50, 40, 6, 34, 80.453125, 120.000000, 347
1705840740294, 50, 14, 2, 12, 187.962891, 281.000000, 45
1705840740396, 50, 70, 11, 59, 53.356473, 80.000000, 1664
1705840742115, 50, 78, 13, 65, 43.665966, 65.000000, 2142
1705840744308, 50, 19, 3, 16, 134.221012, 201.000000, 74
1705840746296, 50, 90, 15, 75, 37.211111, 55.000000, 4866
1705840751531, 50, 43, 7, 36, 82.192951, 123.000000, 960
1705840752554, 50, 18, 3, 15, 140.571615, 198.000000, 65
1705840752678, 50, 80, 13, 67, 42.978271, 65.000000, 2683
1705840755418, 50, 75, 12, 63, 47.242708, 71.000000, 1712
1705840757181, 50, 73, 12, 61, 46.614619, 69.000000, 2007
1705840759241, 50, 114, 19, 95, 29.882813, 44.000000, 3008
1705840762301, 50, 68, 11, 57, 55.301471, 82.000000, 1557
1705840763917, 50, 61, 10, 51, 52.908427, 79.000000, 1349
1705840765320, 50, 75, 12, 63, 49.261458, 73.000000, 1787
1705840768951, 50, 96, 16, 80, 34.820964, 53.000000, 4481
1705840773797, 50, 62, 10, 52, 58.615801, 87.000000, 2045
1705840775896, 50, 112, 18, 94, 31.688756, 47.000000, 3837
1705840779801, 50, 91, 15, 76, 43.195742, 65.000000, 2574
1705840782430, 50, 72, 12, 60, 47.579590, 71.000000, 2465
1705840784957, 50, 105, 17, 88, 33.278274, 49.000000, 2622
1705840787644, 50, 100, 16, 84, 37.139062, 55.000000, 2189
1705840789884, 50, 16, 2, 14, 162.421387, 240.000000, 49
1705840789983, 50, 109, 18, 91, 30.572678, 45.000000, 2477
1705840792512, 50, 97, 16, 81, 37.207233, 54.000000, 2442
1705840796887, 50, 108, 18, 90, 30.415943, 43.000000, 3614
1705840800884, 50, 63, 10, 53, 59.192832, 89.000000, 2705
1705840803646, 50, 98, 16, 82, 35.822465, 53.000000, 3424
1705840807124, 50, 39, 6, 33, 89.405048, 133.000000, 737
1705840807914, 50, 108, 18, 90, 32.619575, 48.000000, 2647
1705840810613, 50, 117, 19, 98, 30.993423, 46.000000, 5623
1705840816292, 50, 85, 14, 71, 39.903493, 59.000000, 1845
1705840818200, 50, 24, 4, 20, 117.070313, 167.000000, 110
1705840818370, 50, 108, 18, 90, 32.395110, 48.000000, 2444
1705840820874, 50, 103, 17, 86, 34.711089, 53.000000, 3405
1705840826289, 50, 24, 4, 20, 116.384766, 172.000000, 720
1705840827360, 50, 26, 4, 22, 112.786659, 169.000000, 248
1705840827659, 50, 116, 19, 97, 31.594154, 47.000000, 3902
1705840831616, 50, 82, 13, 69, 43.572837, 65.000000, 2676
1705840834349, 50, 104, 17, 87, 33.683894, 51.000000, 2823
1705840837224, 50, 27, 4, 23, 104.203125, 153.000000, 169
1705840837446, 50, 86, 14, 72, 41.237679, 61.000000, 3553
1705840841054, 50, 60, 10, 50, 60.023438, 91.000000, 1776
1705840842887, 50, 108, 18, 90, 34.250579, 50.000000, 1941
1705840844887, 50, 72, 12, 60, 49.820421, 74.000000, 2400
1705840849698, 50, 19, 3, 16, 132.941201, 196.000000, 466
1705840850580, 50, 45, 7, 38, 70.326389, 105.000000, 1060
1705840851696, 50, 104, 17, 87, 35.596454, 49.000000, 3923
1705840855678, 50, 22, 3, 19, 129.319070, 187.000000, 105
1705840855835, 50, 87, 14, 73, 40.440194, 60.000000, 2117
1705840858007, 50, 58, 9, 49, 64.693696, 97.000000, 1163
1705840859225, 50, 82, 13, 69, 44.238662, 66.000000, 2506
1705840861784, 50, 24, 4, 20, 131.835938, 195.000000, 138
1705840861973, 50, 40, 6, 34, 79.916016, 119.000000, 569
1705840862592, 50, 54, 9, 45, 68.308738, 95.000000, 1141
1705840865847, 50, 100, 16, 84, 30.800781, 46.000000, 4876
1705840871069, 50, 25, 4, 21, 126.511875, 189.000000, 1085
1705840872206, 50, 66, 11, 55, 60.409328, 91.000000, 1746
1705840874005, 50, 37, 6, 31, 90.352196, 135.000000, 417
1705840874474, 50, 118, 19, 99, 29.620432, 45.000000, 5683
1705840880207, 50, 70, 11, 59, 47.732924, 71.000000, 1593
1705840881853, 50, 34, 5, 29, 90.380515, 135.000000, 223
1705840882126, 50, 50, 8, 42, 70.567187, 105.000000, 687
1705840882868, 50, 40, 6, 34, 76.812939, 106.000000, 591
1705840883510, 50, 110, 18, 92, 32.804688, 49.000000, 2318
1705840888043, 50, 25, 4, 21, 121.145625, 173.000000, 1173
1705840889624, 50, 104, 17, 87, 32.741887, 49.000000, 4398
1705840894084, 50, 108, 18, 90, 30.588433, 45.000000, 5136
1705840899290, 50, 33, 5, 28, 92.539063, 138.000000, 370
1705840899725, 50, 64, 10, 54, 51.187744, 76.000000, 1094
1705840900872, 50, 34, 5, 29, 86.053309, 128.000000, 245
1705840901171, 50, 118, 19, 99, 28.127648, 42.000000, 3648
1705840904879, 50, 28, 4, 24, 106.312500, 159.000000, 118
1705840905056, 50, 44, 7, 37, 76.310369, 114.000000, 530
1705840905646, 50, 14, 2, 12, 195.784598, 293.000000, 48
1705840907936, 50, 48, 8, 40, 68.621419, 102.000000, 1579
1705840909863, 50, 24, 4, 20, 120.023437, 176.000000, 177
1705840910092, 50, 14, 2, 12, 190.019531, 281.000000, 89
1705840910231, 50, 87, 14, 73, 40.051006, 61.000000, 2991
1705840913285, 50, 24, 4, 20, 111.493164, 165.000000, 220
1705840913565, 50, 63, 10, 53, 56.288442, 85.000000, 1455
1705840915073, 50, 67, 11, 56, 52.307603, 78.000000, 1361
1705840916486, 50, 97, 16, 81, 38.873389, 58.000000, 2763
1705840919309, 50, 22, 3, 19, 124.376420, 184.000000, 69
1705840919429, 50, 62, 10, 52, 56.150958, 84.000000, 1610
1705840922914, 50, 110, 18, 92, 36.418679, 54.000000, 9282
1705840932565, 50, 32, 5, 27, 85.660400, 128.000000, 729
1705840933345, 50, 85, 14, 71, 41.228768, 61.000000, 2462
1705840935861, 50, 25, 4, 21, 111.830625, 165.000000, 111
1705840936024, 50, 27, 4, 23, 117.140625, 175.000000, 136
1705840936211, 50, 39, 6, 33, 87.083333, 130.000000, 358
1705840936621, 50, 100, 16, 84, 35.060937, 53.000000, 2335
1705840939033, 50, 28, 4, 24, 101.239676, 150.000000, 150
1705840939240, 50, 75, 12, 63, 48.786458, 73.000000, 1760
1705840941067, 50, 44, 7, 37, 73.240412, 101.000000, 527
1705840943646, 50, 100, 16, 84, 38.267188, 56.000000, 4698
1705840948732, 50, 67, 11, 56, 58.681786, 88.000000, 3276
1705840952072, 50, 15, 2, 13, 169.714063, 253.000000, 43
1705840952174, 50, 90, 15, 75, 41.743924, 62.000000, 2095
1705840954331, 50, 81, 13, 68, 44.751157, 67.000000, 2361
1705840956760, 50, 98, 16, 82, 38.539381, 57.000000, 4790
1705840961603, 50, 32, 5, 27, 100.379883, 150.000000, 216
1705840961871, 50, 50, 8, 42, 69.765625, 104.000000, 720
1705840962654, 50, 88, 14, 74, 43.468395, 65.000000, 3068
1705840965790, 50, 102, 17, 85, 33.689491, 50.000000, 3164
1705840971399, 50, 27, 4, 23, 99.414641, 147.000000, 565
1705840972365, 50, 36, 6, 30, 84.761719, 127.000000, 551
1705840972972, 50, 100, 16, 84, 38.322656, 57.000000, 4288
1705840977333, 50, 43, 7, 36, 73.055505, 109.000000, 549
1705840977934, 50, 99, 16, 83, 34.807686, 49.000000, 2782
1705840980769, 50, 72, 12, 60, 46.159939, 69.000000, 1578
1705840982407, 50, 106, 17, 89, 32.421949, 47.000000, 3137
1705840985596, 50, 67, 11, 56, 56.805037, 85.000000, 1295
1705840986942, 50, 64, 10, 54, 57.113647, 85.000000, 1274
1705840988269, 50, 34, 5, 29, 93.060662, 139.000000, 222
1705840990399, 50, 62, 10, 52, 65.378024, 99.000000, 2658
1705840993459, 50, 76, 12, 64, 47.103413, 70.000000, 2100
1705840995625, 50, 99, 16, 83, 36.704309, 53.000000, 3290
1705840998972, 50, 73, 12, 61, 51.373716, 77.000000, 1800
1705841000825, 50, 48, 8, 40, 74.612467, 111.000000, 914
1705841001795, 50, 105, 17, 88, 28.787798, 43.000000, 3307
1705841005168, 50, 67, 11, 56, 53.315882, 79.000000, 1388
1705841006621, 50, 81, 13, 68, 45.240837, 67.000000, 2268
1705841008942, 50, 68, 11, 57, 47.696461, 71.000000, 1498
1705841010494, 50, 84, 14, 70, 38.656669, 57.000000, 4565
1705841017527, 50, 43, 7, 36, 78.395712, 114.000000, 1237
1705841019152, 50, 93, 15, 78, 42.911710, 64.000000, 4543
1705841023748, 50, 88, 14, 74, 40.155540, 61.000000, 2933
1705841026739, 50, 112, 18, 94, 30.162877, 45.000000, 2984
1705841029787, 50, 82, 13, 69, 40.403963, 60.000000, 1664
1705841031511, 50, 27, 4, 23, 111.890625, 167.000000, 115
1705841031688, 50, 68, 11, 57, 55.587316, 83.000000, 1552
1705841033292, 50, 64, 10, 54, 55.245117, 83.000000, 1090
1705841034437, 50, 52, 8, 44, 63.371394, 95.000000, 731
1705841035221, 50, 115, 19, 96, 29.116423, 43.000000, 7237
1705841044814, 50, 67, 11, 56, 55.852379, 83.000000, 2619
1705841047817, 50, 56, 9, 47, 63.593471, 95.000000, 1109
1705841048978, 50, 52, 8, 44, 66.391526, 99.000000, 1244
1705841050278, 50, 88, 14, 74, 42.604048, 63.000000, 2590
1705841052927, 50, 33, 5, 28, 90.415483, 135.000000, 327
1705841053306, 50, 43, 7, 36, 76.773256, 110.000000, 425
1705841053786, 50, 40, 6, 34, 81.859375, 122.000000, 574
1705841054414, 50, 90, 15, 75, 42.090278, 63.000000, 2279
1705841056760, 50, 34, 5, 29, 88.033778, 131.000000, 373
1705841057186, 50, 112, 18, 94, 30.522461, 45.000000, 3348
1705841062601, 50, 64, 10, 54, 55.780029, 83.000000, 3245
1705841066569, 50, 69, 11, 58, 57.931386, 86.000000, 2246
1705841068872, 50, 88, 14, 74, 39.858842, 59.000000, 2607
1705841071530, 50, 88, 14, 74, 39.017351, 59.000000, 4513
1705841076104, 50, 108, 18, 90, 35.156738, 51.000000, 5563
1705841081718, 50, 64, 10, 54, 55.942383, 83.000000, 1062
1705841082843, 50, 20, 3, 17, 135.860742, 203.000000, 103
1705841082998, 50, 44, 7, 37, 79.616477, 119.000000, 519
1705841083568, 50, 103, 17, 86, 34.080742, 51.000000, 4228
1705841087852, 50, 117, 19, 98, 29.413194, 44.000000, 3879
1705841094327, 50, 49, 8, 41, 76.066645, 114.000000, 1992
1705841096681, 50, 87, 14, 73, 39.254939, 59.000000, 3047
1705841099794, 50, 94, 15, 79, 35.873255, 53.000000, 2986
1705841102853, 50, 49, 8, 41, 77.308673, 115.000000, 815
1705841103731, 50, 60, 10, 50, 59.276042, 88.000000, 1098
1705841104889, 50, 60, 10, 50, 60.636719, 90.000000, 1314
1705841106267, 50, 52, 8, 44, 60.792969, 91.000000, 1003
1705841107321, 50, 67, 11, 56, 55.593050, 83.000000, 1736
1705841109110, 50, 14, 2, 12, 184.253627, 276.000000, 48
1705841109448, 50, 45, 7, 38, 72.800347, 109.000000, 622
1705841112476, 50, 72, 12, 60, 55.513129, 83.000000, 3451
1705841116330, 50, 81, 13, 68, 46.741319, 70.000000, 3473
1705841119861, 50, 49, 8, 41, 69.523278, 102.000000, 620
1705841120532, 50, 36, 6, 30, 90.404731, 135.000000, 457
1705841121041, 50, 43, 7, 36, 80.259811, 120.000000, 606
1705841121710, 50, 100, 16, 84, 33.042188, 49.000000, 2793
1705841124571, 50, 22, 3, 19, 126.329190, 189.000000, 112
1705841124733, 50, 88, 14, 74, 40.776789, 61.000000, 4367
1705841129153, 50, 52, 8, 44, 70.479267, 102.000000, 816
1705841130030, 50, 76, 12, 64, 46.030119, 69.000000, 1843
1705841134830, 50, 40, 6, 34, 85.833984, 126.000000, 1011
1705841136217, 50, 69, 11, 58, 49.479167, 75.000000, 2057
1705841138338, 50, 42, 7, 35, 76.882626, 115.000000, 855
1705841139256, 50, 55, 9, 46, 61.911932, 92.000000, 1092
1705841140653, 50, 52, 8, 44, 71.592548, 101.000000, 870
1705841141587, 50, 61, 10, 51, 59.860656, 89.000000, 1586
1705841143234, 50, 82, 13, 69, 44.276200, 67.000000, 2200
1705841145494, 50, 48, 8, 40, 68.393555, 102.000000, 909
1705841146462, 50, 38, 6, 32, 88.750000, 133.000000, 333
1705841146856, 50, 58, 9, 49, 60.063578, 90.000000, 1108
1705841150541, 50, 70, 11, 59, 49.896205, 75.000000, 2650
1705841153566, 50, 70, 11, 59, 55.059598, 80.000000, 1804
1705841155426, 50, 25, 4, 21, 123.980625, 182.000000, 122
1705841155599, 50, 102, 17, 85, 33.092831, 49.000000, 3006
1705841158657, 50, 103, 17, 86, 34.313562, 51.000000, 2939
1705841161659, 50, 24, 4, 20, 135.474609, 187.000000, 103
1705841161818, 50, 20, 3, 17, 148.204687, 217.000000, 59
1705841161930, 50, 31, 5, 26, 99.739415, 149.000000, 208
1705841162190, 50, 117, 19, 98, 30.639022, 45.000000, 2802
1705841165054, 50, 39, 6, 33, 76.547025, 109.000000, 594
1705841167777, 50, 108, 18, 90, 31.436777, 47.000000, 7262
1705841175402, 50, 112, 18, 94, 31.185128, 46.000000, 2597
1705841178059, 50, 58, 9, 49, 62.571340, 93.000000, 2966
1705841181085, 50, 13, 2, 11, 194.853516, 283.000000, 56
1705841181202, 50, 76, 12, 64, 45.969367, 68.000000, 1547
1705841182810, 50, 115, 19, 96, 30.232541, 45.000000, 3776
1705841186640, 50, 33, 5, 28, 91.941761, 137.000000, 224
1705841186915, 50, 64, 10, 54, 53.867188, 81.000000, 1237
1705841188204, 50, 45, 7, 38, 78.951150, 118.000000, 1297
1705841189552, 50, 112, 18, 94, 32.998047, 49.000000, 2907
1705841194576, 50, 69, 11, 58, 53.932292, 80.000000, 2379
1705841197312, 50, 118, 19, 99, 28.929158, 43.000000, 5130
1705841207055, 50, 58, 9, 49, 61.140894, 91.000000, 2149
1705841209621, 50, 117, 19, 98, 28.562951, 42.000000, 5908
1705841215588, 50, 110, 18, 92, 30.767045, 45.000000, 2453
1705841218095, 50, 103, 17, 86, 32.670661, 48.000000, 2529
1705841220689, 50, 70, 11, 59, 46.532645, 69.000000, 1474
1705841222215, 50, 117, 19, 98, 31.083066, 47.000000, 2555
1705841224823, 50, 28, 4, 24, 105.357840, 151.000000, 175
1705841225054, 50, 78, 13, 65, 39.443610, 59.000000, 1807
1705841226923, 50, 82, 13, 69, 44.513148, 67.000000, 1868
1705841229226, 50, 82, 13, 69, 45.418255, 69.000000, 1438
1705841232771, 50, 78, 13, 65, 44.461839, 67.000000, 4373
1705841252680, 50, 13, 2, 11, 190.007136, 285.000000, 202
1705841253240, 50, 82, 13, 69, 44.694169, 67.000000, 3101
1705841256404, 50, 118, 19, 99, 30.945445, 46.000000, 4242
1705841260711, 50, 70, 11, 59, 48.600965, 72.000000, 2334
1705841263098, 50, 48, 8, 40, 70.817057, 104.000000, 893
1705841264045, 50, 42, 7, 35, 80.438988, 120.000000, 649
1705841264751, 50, 22, 3, 19, 116.195313, 174.000000, 127
1705841264930, 50, 64, 10, 54, 57.233887, 85.000000, 1768
1705841266751, 50, 117, 19, 98, 31.387553, 47.000000, 3619
1705841270435, 50, 58, 9, 49, 59.890760, 89.000000, 1085
1705841273963, 50, 81, 13, 68, 43.734568, 65.000000, 2980
1705841277310, 50, 74, 12, 62, 46.035684, 69.000000, 2209
1705841279571, 50, 75, 12, 63, 46.470833, 69.000000, 1822
1705841281457, 50, 50, 8, 42, 73.105469, 109.000000, 1476
1705841282998, 50, 61, 10, 51, 56.995774, 85.000000, 1561
1705841284719, 50, 110, 18, 92, 34.019176, 49.000000, 3328
1705841288104, 50, 18, 3, 15, 143.245660, 214.000000, 142
1705841288298, 50, 39, 6, 33, 72.921875, 109.000000, 619
1705841288969, 50, 85, 14, 71, 40.667463, 61.000000, 2845
1705841291869, 50, 117, 19, 98, 27.670272, 41.000000, 2115
1705841296134, 50, 84, 14, 70, 44.524554, 66.000000, 4172
1705841300649, 50, 68, 11, 57, 51.438017, 77.000000, 3220
1705841303922, 50, 43, 7, 36, 73.431595, 110.000000, 557
1705841304533, 50, 68, 11, 57, 48.635110, 72.000000, 1154
1705841305749, 50, 112, 18, 94, 29.965820, 44.000000, 2745
1705841308555, 50, 43, 7, 36, 76.001544, 113.000000, 697
1705841309305, 50, 93, 15, 78, 37.483619, 56.000000, 2624
1705841311985, 50, 54, 9, 45, 69.884838, 102.000000, 1396
1705841313448, 50, 45, 7, 38, 77.213151, 110.000000, 1053
1705841314566, 50, 109, 18, 91, 32.451978, 48.000000, 3319
1705841320270, 50, 97, 16, 81, 38.952561, 58.000000, 5223
1705841325874, 50, 63, 10, 53, 51.020089, 76.000000, 2109
1705841328043, 50, 114, 19, 95, 29.414063, 44.000000, 3095
1705841331210, 50, 24, 4, 20, 127.880859, 179.000000, 221
1705841331491, 50, 102, 17, 85, 35.668658, 53.000000, 3396
1705841334943, 50, 92, 15, 77, 37.824134, 56.000000, 3128
1705841338125, 50, 84, 14, 70, 43.226935, 65.000000, 2199
1705841340389, 50, 102, 17, 85, 33.011439, 49.000000, 6837
1705841347276, 50, 26, 4, 22, 120.554688, 180.000000, 139
1705841347472, 50, 13, 2, 11, 183.537260, 270.000000, 36
1705841349939, 50, 48, 8, 40, 67.817383, 100.000000, 1632
1705841351955, 50, 80, 13, 67, 40.981104, 61.000000, 3160
1705841355168, 50, 13, 2, 11, 224.888221, 327.000000, 44
1705841355263, 50, 98, 16, 82, 34.714975, 51.000000, 3252
1705841358577, 50, 73, 12, 61, 46.035959, 69.000000, 1614
1705841360246, 50, 88, 14, 74, 36.434659, 54.000000, 1742
1705841362051, 50, 108, 18, 90, 32.815882, 49.000000, 2965
1705841365070, 50, 97, 16, 81, 38.110100, 57.000000, 3273
1705841368397, 50, 111, 18, 93, 31.987613, 47.000000, 2421
1705841370881, 50, 70, 11, 59, 47.818080, 71.000000, 1251
1705841374252, 50, 73, 12, 61, 47.377997, 71.000000, 2834
1705841377454, 50, 26, 4, 22, 109.379207, 163.000000, 327
1705841377836, 50, 115, 19, 96, 29.322486, 43.000000, 5682
1705841383577, 50, 56, 9, 47, 67.086635, 99.000000, 1333
1705841384976, 50, 68, 11, 57, 50.184972, 75.000000, 1465
1705841386500, 50, 20, 3, 17, 123.798340, 185.000000, 104
1705841386658, 50, 19, 3, 16, 138.854852, 205.000000, 74
1705841386786, 50, 43, 7, 36, 79.465843, 115.000000, 476
1705841387315, 50, 58, 9, 49, 60.792767, 90.000000, 1720
1705841389095, 50, 30, 5, 25, 97.527083, 146.000000, 303
1705841391486, 50, 110, 18, 92, 30.618608, 45.000000, 5938
1705841397807, 50, 111, 18, 93, 33.485360, 51.000000, 3249
1705841401108, 50, 76, 12, 64, 47.949219, 71.000000, 1903
1705841403119, 50, 48, 8, 40, 69.858398, 104.000000, 682
1705841403864, 50, 61, 10, 51, 60.225282, 91.000000, 1307
1705841405225, 50, 79, 13, 66, 45.451938, 69.000000, 1445
1705841406725, 50, 66, 11, 55, 55.536222, 83.000000, 1925
1705841408705, 50, 62, 10, 52, 56.382308, 85.000000, 963
1705841409731, 50, 13, 2, 11, 212.771034, 303.000000, 38
1705841409827, 50, 105, 17, 88, 32.452232, 48.000000, 2766
1705841414547, 50, 21, 3, 18, 117.352493, 171.000000, 461
1705841415368, 50, 20, 3, 17, 117.057129, 175.000000, 108
1705841415538, 50, 15, 2, 13, 175.368750, 253.000000, 43
1705841415637, 50, 34, 5, 29, 85.393153, 128.000000, 577
1705841416269, 50, 61, 10, 51, 55.305328, 82.000000, 1864
1705841418186, 50, 112, 18, 94, 29.845633, 45.000000, 4916
1705841423163, 50, 22, 3, 19, 123.923118, 185.000000, 100
1705841423320, 50, 91, 15, 76, 40.551168, 61.000000, 2513
1705841425883, 50, 118, 19, 99, 29.386123, 44.000000, 3146
1705841429081, 50, 86, 14, 72, 37.223837, 55.000000, 1803
1705841432908, 50, 70, 11, 59, 49.353027, 74.000000, 3854
1705841437123, 50, 52, 8, 44, 69.790565, 99.000000, 940
1705841438118, 50, 31, 5, 26, 95.999496, 143.000000, 252
1705841438422, 50, 33, 5, 28, 81.805398, 122.000000, 183
1705841438665, 50, 94, 15, 79, 36.904089, 55.000000, 2526
1705841441246, 50, 15, 2, 13, 161.268750, 239.000000, 54
1705841441353, 50, 34, 5, 29, 113.947610, 169.000000, 264
1705841441670, 50, 69, 11, 58, 54.500000, 81.000000, 1687
1705841443410, 50, 45, 7, 38, 79.430556, 113.000000, 561
1705841444025, 50, 100, 16, 84, 35.565625, 53.000000, 1810
1705841447742, 50, 102, 17, 85, 38.710172, 58.000000, 5536
1705841453656, 50, 117, 19, 98, 31.682592, 47.000000, 7053
1705841460781, 50, 34, 5, 29, 88.072610, 132.000000, 519
1705841461352, 50, 91, 15, 76, 38.815891, 59.000000, 2820
1705841464225, 50, 20, 3, 17, 128.552344, 176.000000, 79
1705841464356, 50, 91, 15, 76, 37.089715, 55.000000, 2670
1705841467079, 50, 51, 8, 43, 70.726103, 106.000000, 639
1705841467773, 50, 39, 6, 33, 86.893029, 130.000000, 330
1705841468155, 50, 111, 18, 93, 37.346002, 57.000000, 3250
1705841471458, 50, 117, 19, 98, 30.677083, 47.000000, 3202
1705841476755, 50, 22, 3, 19, 125.233887, 187.000000, 515
1705841477645, 50, 40, 6, 34, 88.431641, 129.000000, 489
1705841478193, 50, 30, 5, 25, 91.420313, 137.000000, 486
1705841478746, 50, 33, 5, 28, 102.347124, 153.000000, 491
1705841479289, 50, 102, 17, 85, 39.255362, 59.000000, 4740
1705841484099, 50, 57, 9, 48, 66.044682, 97.000000, 1276
1705841485430, 50, 36, 6, 30, 86.297092, 126.000000, 322
1705841485813, 50, 44, 7, 37, 72.319780, 108.000000, 827
1705841486693, 50, 24, 4, 20, 120.392578, 166.000000, 100
1705841486844, 50, 22, 3, 19, 120.583984, 172.000000, 131
1705841488780, 50, 44, 7, 37, 74.842108, 112.000000, 1434
1705841490572, 50, 84, 14, 70, 42.067708, 63.000000, 3205
1705841493841, 50, 26, 4, 22, 101.948918, 152.000000, 156
1705841494054, 50, 76, 12, 64, 46.556641, 69.000000, 1636
1705841495762, 50, 69, 11, 58, 49.185377, 73.000000, 1365
1705841497188, 50, 114, 19, 95, 30.003598, 44.000000, 3131
1705841500373, 50, 69, 11, 58, 52.484262, 79.000000, 1443
1705841501873, 50, 100, 16, 84, 34.059453, 51.000000, 2669
1705841504604, 50, 99, 16, 83, 31.310547, 43.000000, 2374
1705841507040, 50, 112, 18, 94, 31.079102, 47.000000, 2246
1705841511209, 50, 72, 12, 60, 47.417535, 71.000000, 2569
1705841514192, 50, 52, 8, 44, 71.763822, 102.000000, 1326
1705841515573, 50, 62, 10, 52, 57.196321, 85.000000, 1174
1705841516801, 50, 31, 5, 26, 94.381048, 140.000000, 251
1705841517105, 50, 104, 17, 87, 33.055889, 49.000000, 3066
1705841520239, 50, 31, 5, 26, 96.467994, 144.000000, 252
1705841520553, 50, 46, 7, 39, 69.287109, 103.000000, 627
1705841521248, 50, 13, 2, 11, 199.975962, 296.000000, 39
1705841521345, 50, 96, 16, 80, 39.320475, 58.000000, 2113
1705841523519, 50, 100, 16, 84, 36.705322, 55.000000, 4876
1705841530568, 50, 14, 2, 12, 169.797991, 254.000000, 177
1705841531124, 50, 70, 11, 59, 53.332143, 79.000000, 2682
1705841533872, 50, 105, 17, 88, 36.252232, 54.000000, 3852
1705841537778, 50, 69, 11, 58, 53.676857, 80.000000, 2930
1705841540775, 50, 58, 9, 49, 56.764547, 85.000000, 1073
1705841541908, 50, 108, 18, 90, 28.725405, 43.000000, 3030
1705841544992, 50, 88, 14, 74, 39.228604, 59.000000, 2475
1705841547533, 50, 37, 6, 31, 75.686022, 108.000000, 337
1705841547932, 50, 86, 14, 72, 40.894804, 61.000000, 2167
1705841550165, 50, 115, 19, 96, 29.197011, 43.000000, 3054
1705841555195, 50, 62, 10, 52, 59.725554, 89.000000, 2877
1705841558442, 50, 24, 4, 20, 121.236328, 175.000000, 115
1705841558614, 50, 115, 19, 96, 31.713995, 47.000000, 3424
1705841562101, 50, 75, 12, 63, 48.232292, 73.000000, 2345
1705841564500, 50, 58, 9, 49, 60.474542, 90.000000, 963
1705841565515, 50, 112, 18, 94, 33.956055, 51.000000, 3256
1705841568840, 50, 104, 17, 87, 34.411809, 50.000000, 2141
1705841571045, 50, 63, 10, 53, 52.542163, 78.000000, 983
1705841572083, 50, 85, 14, 71, 39.436213, 59.000000, 2397
1705841574532, 50, 93, 15, 78, 40.992019, 61.000000, 2637
1705841579318, 50, 44, 7, 37, 72.825639, 109.000000, 1720
1705841581399, 50, 74, 12, 62, 48.114073, 73.000000, 2911
1705841584370, 50, 111, 18, 93, 31.733530, 47.000000, 3126
1705841587558, 50, 34, 5, 29, 91.087776, 136.000000, 206
1705841587824, 50, 14, 2, 12, 175.222377, 261.000000, 57
1705841587940, 50, 85, 14, 71, 44.129596, 66.000000, 1918
1705841589922, 50, 91, 15, 76, 38.153331, 57.000000, 2233
1705841592216, 50, 66, 11, 55, 51.092211, 76.000000, 1451
1705841593727, 50, 110, 18, 92, 31.455256, 47.000000, 2148
1705841595937, 50, 13, 2, 11, 206.839543, 304.000000, 40
1705841598546, 50, 40, 6, 34, 78.761523, 116.000000, 1437
1705841600343, 50, 110, 18, 92, 33.555114, 51.000000, 6754
1705841607149, 50, 104, 17, 87, 37.309195, 55.000000, 3086
1705841610298, 50, 106, 17, 89, 33.580483, 49.000000, 3016
1705841613375, 50, 87, 14, 73, 41.826666, 62.000000, 3610
1705841617036, 50, 91, 15, 76, 38.764080, 59.000000, 2366
1705841619468, 50, 103, 17, 86, 34.367415, 51.000000, 3096
1705841622616, 50, 73, 12, 61, 47.957780, 71.000000, 2020
1705841624688, 50, 48, 8, 40, 71.069987, 106.000000, 637
1705841625387, 50, 100, 16, 84, 35.675469, 53.000000, 2897
1705841630633, 50, 52, 8, 44, 66.796875, 99.000000, 1776
1705841632769, 50, 24, 4, 20, 127.300781, 189.000000, 191
1705841633012, 50, 40, 6, 34, 84.011078, 126.000000, 951
1705841634017, 50, 112, 18, 94, 31.509556, 47.000000, 4562
1705841638643, 50, 39, 6, 33, 82.365259, 120.000000, 796
1705841639508, 50, 74, 12, 62, 43.307644, 64.000000, 1351
1705841640923, 50, 72, 12, 60, 52.257053, 79.000000, 2269
1705841643254, 50, 72, 12, 60, 52.736545, 79.000000, 1761
1705841645078, 50, 102, 17, 85, 32.923866, 49.000000, 2939
1705841648077, 50, 49, 8, 41, 64.703444, 97.000000, 881
1705841651280, 50, 78, 13, 65, 46.033754, 69.000000, 3965
1705841655626, 50, 81, 13, 68, 45.627194, 69.000000, 3918
1705841659603, 50, 13, 2, 11, 176.022536, 263.000000, 40
1705841659694, 50, 26, 4, 22, 114.539063, 168.000000, 111
1705841659857, 50, 30, 5, 25, 104.039063, 156.000000, 333
1705841660241, 50, 18, 3, 15, 139.837240, 200.000000, 82
1705841660375, 50, 20, 3, 17, 135.355859, 197.000000, 107
1705841660534, 50, 105, 17, 88, 32.041815, 48.000000, 2674
1705841663544, 50, 27, 4, 23, 100.968750, 145.000000, 209
1705841663945, 50, 87, 14, 73, 46.180136, 69.000000, 2509
1705841668736, 50, 64, 10, 54, 56.208298, 84.000000, 4146
1705841673236, 50, 13, 2, 11, 188.197716, 272.000000, 44
1705841673333, 50, 85, 14, 71, 39.910915, 59.000000, 3929
1705841677329, 50, 60, 10, 50, 56.894010, 85.000000, 1282
1705841678672, 50, 16, 2, 14, 169.688721, 236.000000, 87
1705841678822, 50, 15, 2, 13, 165.160938, 247.000000, 39
1705841678922, 50, 84, 14, 70, 38.858817, 59.000000, 1918
1705841680902, 50, 74, 12, 62, 43.528294, 65.000000, 1771
1705841682734, 50, 88, 14, 74, 41.292347, 61.000000, 3347
1705841686133, 50, 44, 7, 37, 77.997159, 116.000000, 526
1705841688971, 50, 103, 17, 86, 30.408070, 45.000000, 5487
1705841694846, 50, 43, 7, 36, 75.565044, 111.000000, 1167
1705841696068, 50, 21, 3, 18, 133.656250, 192.000000, 99
1705841696219, 50, 60, 10, 50, 57.382682, 87.000000, 1851
1705841698124, 50, 114, 19, 95, 31.010759, 46.000000, 3835
1705841702015, 50, 118, 19, 99, 28.524828, 43.000000, 3678
1705841705751, 50, 92, 15, 77, 38.912704, 58.000000, 3595
1705841709398, 50, 69, 11, 58, 53.394475, 81.000000, 1250
1705841710699, 50, 66, 11, 55, 54.112216, 81.000000, 1205
1705841711955, 50, 24, 4, 20, 111.397380, 167.000000, 187
1705841714420, 50, 22, 3, 19, 136.227273, 197.000000, 395
1705841715168, 50, 97, 16, 81, 35.747423, 51.000000, 3978
1705841719198, 50, 100, 16, 84, 30.474219, 45.000000, 2472
1705841721721, 50, 52, 8, 44, 70.193810, 105.000000, 772
1705841722545, 50, 56, 9, 47, 63.165458, 93.000000, 900
1705841723498, 50, 94, 15, 79, 40.867686, 60.000000, 1925
1705841725483, 50, 68, 11, 57, 59.083410, 89.000000, 2016
1705841727554, 50, 55, 9, 46, 61.938920, 91.000000, 990
1705841728595, 50, 67, 11, 56, 52.879431, 79.000000, 1543
1705841730208, 50, 49, 8, 41, 68.663076, 99.000000, 1707
1705841734050, 50, 80, 13, 67, 46.793359, 71.000000, 4283
1705841738693, 50, 54, 9, 45, 62.893519, 94.000000, 1463
1705841740208, 50, 90, 15, 75, 40.012153, 61.000000, 2616
1705841742885, 50, 54, 9, 45, 71.579861, 107.000000, 1055
1705841743995, 50, 40, 6, 34, 84.460938, 126.000000, 359
1705841744406, 50, 84, 14, 70, 39.265253, 59.000000, 2282
1705841746740, 50, 67, 11, 56, 50.845382, 76.000000, 1283
1705841748082, 50, 54, 9, 45, 67.511574, 99.000000, 964
1705841749103, 50, 42, 7, 35, 76.688151, 113.000000, 924
1705841750087, 50, 26, 4, 22, 108.308293, 162.000000, 113
1705841752436, 50, 118, 19, 99, 29.259799, 43.000000, 5901
1705841758801, 50, 99, 16, 83, 36.114317, 53.000000, 5403
1705841764261, 50, 30, 5, 25, 96.060938, 140.000000, 715
1705841765029, 50, 67, 11, 56, 49.804104, 75.000000, 1360
1705841766447, 50, 54, 9, 45, 63.745660, 95.000000, 768
1705841767267, 50, 58, 9, 49, 54.397899, 81.000000, 885
1705841768216, 50, 100, 16, 84, 34.021875, 49.000000, 2265
1705841770535, 50, 70, 11, 59, 53.242400, 79.000000, 3681
1705841774269, 50, 56, 9, 47, 59.799107, 89.000000, 845
1705841775166, 50, 68, 11, 57, 50.556066, 75.000000, 1069
1705841778310, 50, 22, 3, 19, 120.464489, 177.000000, 401
1705841779073, 50, 64, 10, 54, 60.413300, 91.000000, 2986
1705841782110, 50, 61, 10, 51, 60.080686, 91.000000, 1217
1705841783378, 50, 46, 7, 39, 75.057745, 110.000000, 684
1705841784127, 50, 48, 8, 40, 74.067383, 107.000000, 1123
1705841785308, 50, 51, 8, 43, 65.312500, 97.000000, 909
1705841786271, 50, 14, 2, 12, 184.826451, 273.000000, 53
1705841786375, 50, 73, 12, 61, 52.624144, 78.000000, 2296
1705841788726, 50, 94, 15, 79, 34.187999, 51.000000, 2268
1705841791051, 50, 26, 4, 22, 119.212139, 178.000000, 126
1705841793492, 50, 55, 9, 46, 57.239407, 85.000000, 2933
1705841796871, 50, 13, 2, 11, 213.797476, 317.000000, 79
1705841797011, 50, 116, 19, 97, 32.559133, 48.000000, 3808
1705841800881, 50, 24, 4, 20, 118.187332, 177.000000, 288
1705841801229, 50, 88, 14, 74, 39.539595, 59.000000, 2573
1705841803863, 50, 58, 9, 49, 66.036369, 99.000000, 1503
1705841805428, 50, 85, 14, 71, 41.862500, 63.000000, 2609
1705841808088, 50, 36, 6, 30, 98.546007, 147.000000, 370
1705841808509, 50, 20, 3, 17, 134.555859, 198.000000, 69
1705841808630, 50, 54, 9, 45, 60.567708, 90.000000, 1227
1705841811805, 50, 103, 17, 86, 35.163835, 53.000000, 4712
1705841816883, 50, 75, 12, 63, 45.569453, 68.000000, 3660
1705841820602, 50, 32, 5, 27, 101.447754, 152.000000, 215
1705841820868, 50, 69, 11, 58, 49.457654, 74.000000, 1044
1705841821963, 50, 88, 14, 74, 36.454545, 54.000000, 3440
1705841825452, 50, 44, 7, 37, 76.748935, 113.000000, 472
1705841825986, 50, 108, 18, 90, 34.557653, 49.000000, 4067
1705841830109, 50, 86, 14, 72, 42.503180, 63.000000, 2878
1705841833041, 50, 78, 13, 65, 51.093750, 77.000000, 2586
1705841835687, 50, 20, 3, 17, 131.167969, 191.000000, 87
1705841838008, 50, 28, 4, 24, 104.007254, 154.000000, 484
1705841838843, 50, 18, 3, 15, 147.447700, 217.000000, 177
1705841839080, 50, 64, 10, 54, 52.425659, 78.000000, 1987
1705841841117, 50, 13, 2, 11, 197.138672, 295.000000, 57
1705841841240, 50, 14, 2, 12, 184.747768, 273.000000, 40
1705841841329, 50, 34, 5, 29, 96.227482, 143.000000, 255
1705841841633, 50, 15, 2, 13, 163.014063, 236.000000, 46
1705841841728, 50, 116, 19, 97, 33.577990, 48.000000, 5122
1705841846902, 50, 73, 12, 61, 41.359161, 62.000000, 1505
1705841848462, 50, 32, 5, 27, 89.634949, 127.000000, 396
1705841850751, 50, 54, 9, 45, 65.837674, 98.000000, 2306
1705841853404, 50, 82, 13, 69, 43.861471, 65.000000, 2213
1705841855668, 50, 28, 4, 24, 104.097656, 152.000000, 157
1705841855879, 50, 14, 2, 12, 178.044643, 265.000000, 98
1705841856028, 50, 61, 10, 51, 51.150102, 77.000000, 1029
1705841857113, 50, 42, 7, 35, 80.615699, 120.000000, 613
1705841857777, 50, 82, 13, 69, 41.109947, 61.000000, 1811
1705841859648, 50, 70, 11, 59, 50.150670, 75.000000, 1578
1705841861280, 50, 37, 6, 31, 93.355152, 140.000000, 403
1705841861735, 50, 108, 18, 90, 35.954861, 53.000000, 3506
1705841867434, 50, 64, 10, 54, 60.860107, 91.000000, 3615
1705841871422, 50, 68, 11, 57, 53.415671, 80.000000, 1184
1705841872666, 50, 78, 13, 65, 44.881185, 67.000000, 3572
1705841876304, 50, 91, 15, 76, 36.146978, 55.000000, 2246
1705841878603, 50, 21, 3, 18, 131.974516, 197.000000, 83
1705841878739, 50, 110, 18, 92, 34.646058, 51.000000, 4131
1705841882936, 50, 80, 13, 67, 46.806738, 71.000000, 2442
1705841885429, 50, 50, 8, 42, 72.493984, 108.000000, 1374
1705841886865, 50, 92, 15, 77, 39.287534, 58.000000, 2144
1705841889069, 50, 51, 8, 43, 71.762561, 104.000000, 908
1705841891950, 50, 69, 11, 58, 51.547441, 77.000000, 3573
1705841895905, 50, 69, 11, 58, 57.116395, 85.000000, 1825
1705841897802, 50, 82, 13, 69, 41.854992, 62.000000, 2700
1705841900568, 50, 73, 12, 61, 48.828339, 73.000000, 2262
1705841902883, 50, 25, 4, 21, 117.298125, 173.000000, 141
1705841903075, 50, 110, 18, 92, 32.726065, 47.000000, 3857
1705841906983, 50, 38, 6, 32, 87.766036, 131.000000, 366
1705841907410, 50, 87, 14, 73, 39.498024, 59.000000, 2444
1705841909906, 50, 80, 13, 67, 46.256836, 69.000000, 1771
1705841911727, 50, 49, 8, 41, 65.918367, 98.000000, 794
1705841914761, 50, 84, 14, 70, 39.848400, 59.000000, 3471
1705841918574, 50, 96, 16, 80, 36.368815, 52.000000, 3135
1705841921763, 50, 42, 7, 35, 75.963728, 113.000000, 874
1705841922688, 50, 92, 15, 77, 36.519276, 55.000000, 3206
1705841925957, 50, 92, 15, 77, 37.217710, 55.000000, 3889
1705841929900, 50, 118, 19, 99, 29.998676, 44.000000, 4112
1705841934066, 50, 92, 15, 77, 37.054603, 55.000000, 2705
1705841936821, 50, 48, 8, 40, 63.480225, 95.000000, 726
1705841937610, 50, 26, 4, 22, 120.769832, 175.000000, 124
1705841937796, 50, 102, 17, 85, 35.564415, 52.000000, 2686
1705841942772, 50, 118, 19, 99, 32.341764, 48.000000, 4975
1705841948084, 50, 64, 10, 54, 57.811035, 86.000000, 2492
1705841950630, 50, 102, 17, 85, 34.257047, 51.000000, 3758
1705841954442, 50, 111, 18, 93, 28.344232, 42.000000, 3086
1705841957583, 50, 48, 8, 40, 74.452148, 107.000000, 813
1705841958447, 50, 45, 7, 38, 76.791667, 115.000000, 688
1705841959190, 50, 16, 2, 14, 165.234375, 240.000000, 60
1705841959301, 50, 42, 7, 35, 80.845561, 121.000000, 1329
1705841960683, 50, 56, 9, 47, 63.926060, 95.000000, 1335
1705841962079, 50, 66, 11, 55, 49.524148, 74.000000, 1579
1705841965989, 50, 25, 4, 21, 123.879375, 181.000000, 437
1705841966800, 50, 82, 13, 69, 42.214177, 63.000000, 3292
1705841970153, 50, 98, 16, 82, 33.997409, 51.000000, 4129
1705841974335, 50, 38, 6, 32, 75.016345, 108.000000, 496
1705841974881, 50, 75, 12, 63, 43.976146, 65.000000, 2054
1705841976987, 50, 86, 14, 72, 41.411519, 63.000000, 3713
1705841980760, 50, 72, 12, 60, 52.560330, 78.000000, 1895
1705841982712, 50, 21, 3, 18, 119.664063, 179.000000, 87
1705841982858, 50, 105, 17, 88, 34.533631, 51.000000, 3012
1705841985922, 50, 111, 18, 93, 30.209037, 45.000000, 3247
1705841991331, 50, 51, 8, 43, 61.819853, 92.000000, 1506
1705841993197, 50, 33, 5, 28, 96.102746, 144.000000, 394
1705841993644, 50, 54, 9, 45, 60.941840, 91.000000, 833
1705841994536, 50, 12, 2, 10, 223.984375, 323.000000, 37
1705841995003, 50, 57, 9, 48, 59.687500, 89.000000, 898
1705841995953, 50, 30, 5, 25, 97.659115, 140.000000, 292
1705841996298, 50, 74, 12, 62, 45.568729, 68.000000, 2025
1705841998376, 50, 43, 7, 36, 81.468023, 122.000000, 654
1705841999080, 50, 87, 14, 73, 42.825072, 64.000000, 1812
1705842000950, 50, 92, 15, 77, 37.355724, 57.000000, 2401
1705842005285, 50, 74, 12, 62, 48.584459, 73.000000, 3355
1705842008989, 50, 84, 14, 70, 40.327102, 61.000000, 2691
1705842011735, 50, 26, 4, 22, 113.370793, 170.000000, 129
1705842011917, 50, 114, 19, 95, 32.968339, 49.000000, 5743
1705842017717, 50, 50, 8, 42, 68.607813, 102.000000, 745
1705842018519, 50, 46, 7, 39, 77.187500, 115.000000, 569
1705842019145, 50, 94, 15, 79, 35.709525, 53.000000, 2494
1705842021701, 50, 45, 7, 38, 78.631944, 117.000000, 521
1705842022276, 50, 33, 5, 28, 87.251420, 130.000000, 185
1705842022512, 50, 13, 2, 11, 198.253305, 292.000000, 49
1705842024740, 50, 87, 14, 73, 34.277119, 51.000000, 3257
1705842028369, 50, 31, 5, 26, 98.188004, 147.000000, 898
1705842029322, 50, 12, 2, 10, 224.351563, 325.000000, 55
1705842029431, 50, 118, 19, 99, 27.498676, 41.000000, 2049
1705842031534, 50, 68, 11, 57, 51.167279, 76.000000, 1561
1705842033152, 50, 104, 17, 87, 32.413612, 48.000000, 3975
1705842037192, 50, 99, 16, 83, 35.085227, 53.000000, 3046
1705842040297, 50, 117, 19, 98, 31.149573, 47.000000, 3442
1705842043796, 50, 114, 19, 95, 27.315927, 41.000000, 4010
1705842047878, 50, 93, 15, 78, 40.173891, 61.000000, 1856
1705842052134, 50, 34, 5, 29, 88.344439, 132.000000, 1303
1705842053816, 50, 75, 12, 63, 48.707292, 73.000000, 2136
1705842056007, 50, 38, 6, 32, 79.245503, 118.000000, 674
1705842056732, 50, 36, 6, 30, 90.906467, 136.000000, 587
1705842057371, 50, 51, 8, 43, 65.817555, 99.000000, 881
1705842058303, 50, 24, 4, 20, 112.977824, 166.000000, 256
1705842058614, 50, 20, 3, 17, 140.097266, 208.000000, 92
1705842058760, 50, 22, 3, 19, 118.479692, 175.000000, 173
1705842058983, 50, 27, 4, 23, 99.187500, 146.000000, 148
1705842059182, 50, 42, 7, 35, 87.012649, 130.000000, 667
1705842061856, 50, 78, 13, 65, 46.929087, 71.000000, 3582
1705842065791, 50, 109, 18, 91, 32.370269, 49.000000, 3567
1705842069419, 50, 19, 3, 16, 136.071957, 200.000000, 70
1705842069540, 50, 110, 18, 92, 33.435653, 51.000000, 4539
1705842074141, 50, 40, 6, 34, 79.185742, 118.000000, 469
1705842074672, 50, 75, 12, 63, 47.075729, 70.000000, 2821
1705842077566, 50, 91, 15, 76, 38.594952, 57.000000, 2805
1705842080425, 50, 100, 16, 84, 37.315469, 55.000000, 3996
1705842084481, 50, 88, 14, 74, 40.836293, 61.000000, 2797
1705842087328, 50, 52, 8, 44, 67.282151, 97.000000, 662
1705842090087, 50, 63, 10, 53, 52.824901, 79.000000, 2237
1705842092704, 50, 70, 11, 59, 50.826116, 76.000000, 1698
1705842094455, 50, 62, 10, 52, 61.290323, 91.000000, 1179
1705842095688, 50, 51, 8, 43, 66.447610, 97.000000, 737
1705842096481, 50, 104, 17, 87, 36.079177, 55.000000, 3295
1705842099837, 50, 48, 8, 40, 69.868245, 104.000000, 1199
1705842101098, 50, 51, 8, 43, 65.485600, 99.000000, 1069
1705842102229, 50, 103, 17, 86, 37.445540, 56.000000, 3562
1705842105852, 50, 118, 19, 99, 28.185712, 42.000000, 2578
1705842108491, 50, 44, 7, 37, 81.675249, 122.000000, 609
1705842111258, 50, 108, 18, 90, 35.607928, 53.000000, 5998
1705842117594, 50, 38, 6, 32, 82.526213, 123.000000, 1098
1705842118745, 50, 109, 18, 91, 35.812500, 51.000000, 4305
1705842123105, 50, 49, 8, 41, 72.199896, 105.000000, 1265
1705842124421, 50, 21, 3, 18, 135.334821, 203.000000, 74
1705842124548, 50, 55, 9, 46, 63.231854, 95.000000, 1885
1705842126502, 50, 63, 10, 53, 53.647414, 80.000000, 2308
1705842128862, 50, 32, 5, 27, 102.778076, 154.000000, 323
1705842129237, 50, 85, 14, 71, 42.243566, 63.000000, 2245
1705842131534, 50, 67, 11, 56, 55.865672, 83.000000, 1906
1705842135929, 50, 37, 6, 31, 97.046030, 145.000000, 1007
1705842137299, 50, 114, 19, 95, 30.819730, 46.000000, 6053
1705842143415, 50, 117, 19, 98, 31.675748, 47.000000, 3896
1705842147363, 50, 103, 17, 86, 32.559390, 49.000000, 4280
1705842151696, 50, 99, 16, 83, 34.310211, 48.000000, 3569
1705842155323, 50, 38, 6, 32, 81.608039, 122.000000, 567
1705842155948, 50, 24, 4, 20, 106.587565, 159.000000, 175
1705842156183, 50, 40, 6, 34, 83.458984, 122.000000, 409
1705842156651, 50, 94, 15, 79, 34.317819, 51.000000, 2904
1705842159605, 50, 31, 5, 26, 88.512097, 129.000000, 171
1705842161921, 50, 31, 5, 26, 91.144153, 134.000000, 715
1705842162989, 50, 12, 2, 10, 201.861328, 301.000000, 40
1705842163095, 50, 61, 10, 51, 52.512807, 78.000000, 1360
1705842164508, 50, 15, 2, 13, 167.364063, 249.000000, 44
1705842164604, 50, 97, 16, 81, 36.956347, 55.000000, 2741
1705842167401, 50, 56, 9, 47, 68.016183, 102.000000, 1532
1705842169002, 50, 56, 9, 47, 61.813616, 93.000000, 981
1705842170034, 50, 36, 6, 30, 81.199219, 121.000000, 364
1705842170450, 50, 46, 7, 39, 72.766644, 101.000000, 639
1705842171143, 50, 72, 12, 60, 46.173394, 69.000000, 2506
1705842175622, 50, 72, 12, 60, 51.561415, 77.000000, 2958
1705842178941, 50, 14, 2, 12, 181.757813, 269.000000, 51
1705842179047, 50, 117, 19, 98, 30.557626, 45.000000, 5869
1705842184972, 50, 54, 9, 45, 64.127604, 97.000000, 1145
1705842186169, 50, 52, 8, 44, 66.168870, 99.000000, 782
1705842187011, 50, 94, 15, 79, 38.846410, 58.000000, 2106
1705842189184, 50, 42, 7, 35, 72.460007, 106.000000, 539
1705842189784, 50, 94, 15, 79, 32.356217, 49.000000, 2289
1705842192129, 50, 25, 4, 21, 119.829375, 179.000000, 144
1705842192327, 50, 63, 10, 53, 55.406250, 83.000000, 1417
1705842195915, 50, 26, 4, 22, 107.480769, 159.000000, 446
1705842196716, 50, 111, 18, 93, 30.684192, 46.000000, 5688
1705842202464, 50, 28, 4, 24, 117.748326, 176.000000, 121
1705842202637, 50, 99, 16, 83, 31.756629, 47.000000, 2600
1705842205292, 50, 103, 17, 86, 32.371999, 48.000000, 3662
1705842209013, 50, 13, 2, 11, 195.608060, 293.000000, 58
1705842209134, 50, 68, 11, 57, 51.948099, 77.000000, 2941
1705842212128, 50, 58, 9, 49, 63.981681, 94.000000, 1109
1705842213288, 50, 115, 19, 96, 31.329959, 46.000000, 3133
1705842216480, 50, 80, 13, 67, 44.605469, 65.000000, 1463
1705842220418, 50, 31, 5, 26, 98.905021, 142.000000, 1157
1705842221931, 50, 88, 14, 74, 39.555220, 59.000000, 2475
1705842224459, 50, 110, 18, 92, 30.795241, 47.000000, 3106
1705842227619, 50, 57, 9, 48, 53.359375, 80.000000, 1046
1705842228727, 50, 56, 9, 47, 65.025391, 97.000000, 1122
1705842229900, 50, 112, 18, 94, 30.561384, 45.000000, 3874
1705842233835, 50, 72, 12, 60, 52.370877, 78.000000, 2357
1705842236245, 50, 82, 13, 69, 46.212843, 69.000000, 2088
1705842238388, 50, 90, 15, 75, 38.955382, 59.000000, 3109
1705842241558, 50, 117, 19, 98, 28.229300, 42.000000, 3293
1705842247061, 50, 114, 19, 95, 33.880208, 51.000000, 4750
1705842252187, 50, 84, 14, 70, 38.561430, 57.000000, 7011
1705842259257, 50, 90, 15, 75, 37.570226, 56.000000, 3140
1705842262466, 50, 75, 12, 63, 47.075729, 70.000000, 2443
1705842264960, 50, 97, 16, 81, 34.002899, 50.000000, 2394
1705842267408, 50, 97, 16, 81, 33.986308, 50.000000, 2966
1705842270436, 50, 19, 3, 16, 146.163651, 214.000000, 219
1705842270717, 50, 13, 2, 11, 191.884531, 286.000000, 228
1705842271006, 50, 117, 19, 98, 29.497196, 45.000000, 3409
1705842274468, 50, 117, 19, 98, 28.310472, 43.000000, 3328
1705842280043, 50, 32, 5, 27, 94.209595, 138.000000, 778
1705842281231, 50, 37, 6, 31, 78.391047, 116.000000, 352
1705842281634, 50, 97, 16, 81, 34.645619, 49.000000, 3138
1705842284841, 50, 20, 3, 17, 122.934375, 172.000000, 99
1705842285002, 50, 98, 16, 82, 38.285555, 57.000000, 3606
1705842288671, 50, 31, 5, 26, 106.682208, 160.000000, 333
1705842289067, 50, 100, 16, 84, 35.407969, 53.000000, 2644
1705842291764, 50, 115, 19, 96, 30.580503, 45.000000, 4047
1705842295862, 50, 90, 15, 75, 35.455035, 53.000000, 2328
1705842298247, 50, 69, 11, 58, 56.968297, 84.000000, 1384
1705842301690, 50, 19, 3, 16, 129.404605, 193.000000, 314
1705842302370, 50, 81, 13, 68, 42.295525, 62.000000, 3063
1705842305497, 50, 96, 16, 80, 37.626383, 56.000000, 3893
1705842309451, 50, 98, 16, 82, 36.078444, 54.000000, 2470
1705842311972, 50, 104, 17, 87, 32.527494, 47.000000, 3186
1705842315224, 50, 32, 5, 27, 92.091797, 129.000000, 237
1705842315515, 50, 68, 11, 57, 57.242934, 85.000000, 2291
1705842317870, 50, 115, 19, 96, 28.512908, 42.000000, 2087
1705842320007, 50, 32, 5, 27, 99.064697, 146.000000, 248
1705842320306, 50, 84, 14, 70, 43.417969, 65.000000, 1973
1705842324295, 50, 103, 17, 86, 34.234678, 51.000000, 5851
1705842330729, 50, 97, 16, 81, 34.538499, 51.000000, 3337
1705842334119, 50, 24, 4, 20, 120.234375, 180.000000, 459
1705842334630, 50, 34, 5, 29, 93.625689, 140.000000, 1106
1705842335801, 50, 19, 3, 16, 129.404605, 190.000000, 160
1705842336014, 50, 84, 14, 70, 40.546968, 60.000000, 2802
1705842338870, 50, 39, 6, 33, 82.580980, 123.000000, 592
1705842339515, 50, 90, 15, 75, 40.382986, 61.000000, 2638
1705842342204, 50, 42, 7, 35, 82.100074, 118.000000, 479
1705842342741, 50, 73, 12, 61, 49.566246, 75.000000, 1899
1705842346847, 50, 84, 14, 70, 39.246094, 58.000000, 4077
1705842351281, 50, 61, 10, 51, 61.492059, 93.000000, 1257
1705842352590, 50, 116, 19, 97, 29.700296, 45.000000, 3940
1705842356596, 50, 58, 9, 49, 60.580684, 91.000000, 1090
1705842357739, 50, 31, 5, 26, 99.875252, 149.000000, 251
1705842358042, 50, 60, 10, 50, 58.921802, 88.000000, 2142
1705842360249, 50, 19, 3, 16, 139.376645, 196.000000, 77
1705842360386, 50, 108, 18, 90, 32.903664, 49.000000, 4517
1705842364954, 50, 57, 9, 48, 65.078125, 97.000000, 1000
1705842366006, 50, 64, 10, 54, 48.768311, 73.000000, 1117
1705842369212, 50, 58, 9, 49, 63.871565, 95.000000, 2632
1705842372195, 50, 50, 8, 42, 65.698438, 98.000000, 748
1705842373007, 50, 78, 13, 65, 42.029948, 63.000000, 1755
1705842374823, 50, 64, 10, 54, 51.883545, 77.000000, 1482
1705842376366, 50, 48, 8, 40, 73.714681, 99.000000, 1070
1705842377496, 50, 37, 6, 31, 89.664274, 134.000000, 410
1705842377966, 50, 36, 6, 30, 92.773438, 139.000000, 411
1705842378435, 50, 84, 14, 70, 41.580171, 63.000000, 2024
1705842380509, 50, 55, 9, 46, 60.449774, 90.000000, 1390
1705842381950, 50, 94, 15, 79, 38.170348, 57.000000, 4939
1705842389233, 50, 110, 18, 92, 30.787003, 45.000000, 7123
1705842396697, 50, 114, 19, 95, 30.531181, 45.000000, 5466
1705842402227, 50, 54, 9, 45, 68.666088, 97.000000, 1400
1705842403705, 50, 84, 14, 70, 43.859375, 65.000000, 3552
1705842407325, 50, 79, 13, 66, 45.395570, 68.000000, 1501
1705842408887, 50, 106, 17, 89, 36.360112, 55.000000, 2693
1705842411634, 50, 20, 3, 17, 133.567383, 196.000000, 110
1705842411796, 50, 116, 19, 97, 31.517376, 47.000000, 3340
1705842415189, 50, 20, 3, 17, 128.130859, 191.000000, 81
1705842415322, 50, 75, 12, 63, 48.595833, 72.000000, 1693
1705842419395, 50, 42, 7, 35, 73.652832, 110.000000, 1568
1705842421306, 50, 88, 14, 74, 37.472989, 56.000000, 3350
1705842424717, 50, 56, 9, 47, 56.326730, 84.000000, 789
1705842425570, 50, 52, 8, 44, 64.912861, 95.000000, 708
1705842426339, 50, 66, 11, 55, 55.678622, 83.000000, 1922
1705842428323, 50, 57, 9, 48, 61.529537, 93.000000, 1519
1705842429901, 50, 85, 14, 71, 47.086397, 71.000000, 2431
1705842432383, 50, 58, 9, 49, 61.062837, 91.000000, 1292
1705842433726, 50, 54, 9, 45, 65.202546, 97.000000, 860
1705842434638, 50, 118, 19, 99, 32.341764, 49.000000, 2458
1705842439445, 50, 42, 7, 35, 78.495164, 117.000000, 1133
1705842440981, 50, 88, 14, 74, 37.058771, 55.000000, 2243
1705842443281, 50, 25, 4, 21, 125.852188, 188.000000, 141
1705842443482, 50, 15, 2, 13, 170.189909, 234.000000, 66
1705842443601, 50, 44, 7, 37, 77.794744, 114.000000, 561
1705842444219, 50, 97, 16, 81, 35.028189, 53.000000, 1811
1705842446082, 50, 42, 7, 35, 78.742560, 118.000000, 510
1705842446646, 50, 56, 9, 47, 62.133650, 92.000000, 938
1705842447639, 50, 26, 4, 22, 114.879808, 172.000000, 136
1705842447834, 50, 70, 11, 59, 54.944531, 82.000000, 1744
1705842451458, 50, 61, 10, 51, 56.582592, 84.000000, 3801
1705842455607, 50, 18, 3, 15, 135.052870, 202.000000, 313
1705842455970, 50, 22, 3, 19, 117.066051, 174.000000, 76
1705842456098, 50, 75, 12, 63, 49.595000, 75.000000, 2015
1705842458167, 50, 20, 3, 17, 140.323047, 210.000000, 81
1705842458299, 50, 80, 13, 67, 46.402734, 69.000000, 2159
1705842460513, 50, 81, 13, 68, 42.979745, 64.000000, 2368
1705842462943, 50, 109, 18, 91, 36.234375, 55.000000, 4627
1705842467623, 50, 58, 9, 49, 63.412446, 95.000000, 1501
1705842469176, 50, 61, 10, 51, 59.594006, 89.000000, 883
1705842472521, 50, 51, 8, 43, 66.390931, 99.000000, 2132
1705842475004, 50, 68, 11, 57, 47.085248, 71.000000, 1723
1705842476781, 50, 102, 17, 85, 34.613109, 50.000000, 6875
1705842484005, 50, 68, 11, 57, 52.586167, 78.000000, 1275
1705842485343, 50, 114, 19, 95, 34.092379, 51.000000, 4773
1705842490176, 50, 21, 3, 18, 119.589844, 175.000000, 95
1705842490324, 50, 104, 17, 87, 32.318115, 48.000000, 4898
1705842495282, 50, 40, 6, 34, 80.193359, 119.000000, 382
1705842495726, 50, 105, 17, 88, 32.965253, 49.000000, 3101
1705842498891, 50, 49, 8, 41, 70.341199, 102.000000, 823
1705842502031, 50, 62, 10, 52, 56.023185, 85.000000, 2335
1705842504766, 50, 62, 10, 52, 59.080141, 89.000000, 1718
1705842506541, 50, 106, 17, 89, 31.942807, 47.000000, 4059
1705842510662, 50, 57, 9, 48, 66.666667, 97.000000, 1006
1705842511723, 50, 44, 7, 37, 74.347079, 111.000000, 923
1705842512701, 50, 70, 11, 59, 51.677455, 77.000000, 1622
1705842514379, 50, 60, 10, 50, 60.228320, 91.000000, 2029
1705842516473, 50, 52, 8, 44, 75.103666, 106.000000, 1097
1705842517625, 50, 37, 6, 31, 84.975190, 127.000000, 528
1705842518205, 50, 20, 3, 17, 132.738281, 185.000000, 91
1705842520903, 50, 98, 16, 82, 41.014031, 61.000000, 5852
1705842527087, 50, 94, 15, 79, 34.222071, 49.000000, 4142
1705842531281, 50, 116, 19, 97, 28.279903, 43.000000, 3290
1705842534632, 50, 22, 3, 19, 116.439098, 173.000000, 637
1705842535321, 50, 18, 3, 15, 137.389323, 194.000000, 97
1705842535470, 50, 13, 2, 11, 211.728516, 308.000000, 104
1705842535627, 50, 92, 15, 77, 37.965194, 57.000000, 4185
1705842539874, 50, 91, 15, 76, 39.686641, 59.000000, 2572
1705842542508, 50, 21, 3, 18, 122.063616, 179.000000, 79
1705842542646, 50, 104, 17, 87, 32.313702, 48.000000, 3942
1705842549061, 50, 90, 15, 75, 40.536838, 60.000000, 6704
1705842556111, 50, 55, 9, 46, 63.661222, 95.000000, 1587
1705842557788, 50, 14, 2, 12, 188.603237, 280.000000, 39
1705842557877, 50, 76, 12, 64, 44.453125, 66.000000, 1687
1705842559650, 50, 98, 16, 82, 35.403978, 53.000000, 2796
1705842562506, 50, 55, 9, 46, 64.448864, 96.000000, 955
1705842563523, 50, 90, 15, 75, 40.610069, 60.000000, 2379
1705842565958, 50, 114, 19, 95, 35.468750, 52.000000, 2098
1705842568110, 50, 97, 16, 81, 37.714965, 54.000000, 2085
1705842570256, 50, 112, 18, 94, 31.735910, 47.000000, 2266
1705842574615, 50, 32, 5, 27, 99.638672, 141.000000, 806
1705842575796, 50, 22, 3, 19, 135.187766, 202.000000, 145
1705842575993, 50, 93, 15, 78, 41.083669, 61.000000, 3298
1705842579346, 50, 37, 6, 31, 84.921347, 127.000000, 779
1705842580178, 50, 115, 19, 96, 29.067935, 42.000000, 3190
1705842583443, 50, 84, 14, 70, 43.205915, 65.000000, 2407
1705842585917, 50, 39, 6, 33, 85.751202, 128.000000, 450
1705842586426, 50, 116, 19, 97, 31.351765, 47.000000, 3842
1705842590321, 50, 14, 2, 12, 196.994141, 291.000000, 59
1705842590432, 50, 88, 14, 74, 39.690163, 59.000000, 2116
1705842594653, 50, 73, 12, 61, 45.120933, 67.000000, 2876
1705842597886, 50, 36, 6, 30, 92.567274, 138.000000, 342
1705842598285, 50, 38, 6, 32, 92.695313, 139.000000, 353
1705842598693, 50, 86, 14, 72, 40.580850, 60.000000, 3045
1705842601791, 50, 118, 19, 99, 27.065049, 41.000000, 3163
1705842605006, 50, 98, 16, 82, 33.341119, 49.000000, 3667
1705842608732, 50, 55, 9, 46, 65.105540, 97.000000, 1282
1705842610067, 50, 18, 3, 15, 133.289063, 194.000000, 152
1705842610272, 50, 85, 14, 71, 43.944761, 65.000000, 3099
1705842613423, 50, 64, 10, 54, 52.977417, 79.000000, 1145
1705842616683, 50, 31, 5, 26, 97.509451, 146.000000, 1714
1705842618748, 50, 105, 17, 88, 34.354464, 51.000000, 4010
1705842622811, 50, 92, 15, 77, 37.593410, 57.000000, 2422
1705842625285, 50, 60, 10, 50, 62.249219, 92.000000, 1077
1705842626415, 50, 48, 8, 40, 72.496257, 108.000000, 846
1705842627314, 50, 99, 16, 83, 36.659564, 51.000000, 2330
1705842629698, 50, 68, 11, 57, 50.970818, 76.000000, 1231
1705842630990, 50, 57, 9, 48, 63.958333, 95.000000, 1109
1705842632159, 50, 82, 13, 69, 39.010099, 58.000000, 1762
1705842633982, 50, 55, 9, 46, 61.870313, 92.000000, 1058
1705842636902, 50, 105, 17, 88, 35.681548, 52.000000, 5044
1705842642353, 50, 37, 6, 31, 87.997044, 131.000000, 870
1705842643285, 50, 92, 15, 77, 42.792629, 64.000000, 3004
1705842646342, 50, 42, 7, 35, 84.149926, 124.000000, 518
1705842646912, 50, 22, 3, 19, 115.251065, 172.000000, 132
1705842647097, 50, 32, 5, 27, 94.072266, 139.000000, 227
1705842647377, 50, 78, 13, 65, 46.377404, 69.000000, 1998
1705842649426, 50, 24, 4, 20, 107.605469, 160.000000, 126
1705842649605, 50, 62, 10, 52, 54.959425, 82.000000, 1355
1705842651012, 50, 79, 13, 66, 41.637658, 63.000000, 1590
1705842654672, 50, 116, 19, 97, 30.794518, 45.000000, 7346
1705842662375, 50, 117, 19, 98, 29.091213, 43.000000, 4057
1705842666498, 50, 32, 5, 27, 96.345703, 144.000000, 584
1705842667142, 50, 30, 5, 25, 105.977083, 158.000000, 249
1705842667451, 50, 49, 8, 41, 63.191964, 94.000000, 721
1705842668231, 50, 55, 9, 46, 61.590483, 92.000000, 1091
1705842669386, 50, 66, 11, 55, 55.790246, 83.000000, 1991
1705842671430, 50, 102, 17, 85, 33.107384, 49.000000, 3000
1705842674483, 50, 30, 5, 25, 102.431250, 153.000000, 234
1705842674769, 50, 81, 13, 68, 43.046875, 64.000000, 2012
1705842679243, 50, 115, 19, 96, 30.965353, 45.000000, 5471
1705842685103, 50, 66, 11, 55, 51.302083, 76.000000, 2668
1705842687834, 50, 13, 2, 11, 201.501202, 292.000000, 59
1705842687952, 50, 99, 16, 83, 34.410511, 51.000000, 2532
1705842690538, 50, 13, 2, 11, 198.281250, 297.000000, 47
1705842690640, 50, 49, 8, 41, 71.946747, 107.000000, 763
1705842691457, 50, 56, 9, 47, 68.268415, 100.000000, 1377
1705842692890, 50, 67, 11, 56, 60.396718, 91.000000, 2613
1705842695554, 50, 90, 15, 75, 39.138021, 59.000000, 2387
1705842697994, 50, 118, 19, 99, 30.165519, 45.000000, 3184
1705842703352, 50, 55, 9, 46, 69.518466, 104.000000, 2194
1705842705940, 50, 56, 9, 47, 61.974749, 92.000000, 1240
1705842707234, 50, 52, 8, 44, 66.771635, 100.000000, 1198
1705842708485, 50, 20, 3, 17, 137.105664, 205.000000, 112
1705842708655, 50, 26, 4, 22, 116.048077, 174.000000, 176
1705842708887, 50, 104, 17, 87, 34.295260, 51.000000, 4762
1705842713705, 50, 36, 6, 30, 86.333767, 128.000000, 375
1705842714131, 50, 78, 13, 65, 46.803285, 70.000000, 2331
1705842716516, 50, 32, 5, 27, 98.115723, 147.000000, 326
1705842716895, 50, 76, 12, 64, 50.488692, 73.000000, 2266
1705842721472, 50, 30, 5, 25, 101.207812, 147.000000, 622
1705842722462, 50, 66, 11, 55, 50.963542, 77.000000, 1937
1705842724455, 50, 38, 6, 32, 87.598504, 131.000000, 759
1705842725268, 50, 67, 11, 56, 52.617771, 79.000000, 1526
1705842726866, 50, 58, 9, 49, 68.682920, 102.000000, 1067
1705842727993, 50, 96, 16, 80, 37.882487, 56.000000, 2635
1705842730691, 50, 34, 5, 29, 87.835478, 131.000000, 341
1705842731093, 50, 36, 6, 30, 89.768880, 134.000000, 560
1705842731718, 50, 84, 14, 70, 42.233445, 63.000000, 2098
1705842733874, 50, 16, 2, 14, 170.323730, 248.000000, 51
1705842736059, 50, 27, 4, 23, 107.390625, 161.000000, 490
1705842736905, 50, 33, 5, 28, 95.382576, 142.000000, 575
1705842737532, 50, 82, 13, 69, 44.801734, 67.000000, 2721
1705842740304, 50, 21, 3, 18, 118.608584, 177.000000, 121
1705842740476, 50, 116, 19, 97, 29.137258, 43.000000, 4050
1705842744591, 50, 67, 11, 56, 56.025187, 84.000000, 1493
1705842746139, 50, 111, 18, 93, 32.362050, 48.000000, 2847
1705842749044, 50, 38, 6, 32, 78.777909, 116.000000, 539
1705842749636, 50, 98, 16, 82, 38.169165, 57.000000, 3371
1705842753061, 50, 16, 2, 14, 161.920898, 228.000000, 36
1705842755374, 50, 44, 7, 37, 72.957209, 106.000000, 1515
1705842757251, 50, 109, 18, 91, 31.689364, 47.000000, 3525
1705842760830, 50, 75, 12, 63, 52.269792, 79.000000, 1903
1705842762799, 50, 102, 17, 85, 33.543964, 49.000000, 3284
1705842766150, 50, 96, 16, 80, 37.774251, 57.000000, 2446
1705842768662, 50, 14, 2, 12, 196.471540, 292.000000, 66
1705842768789, 50, 106, 17, 89, 31.269900, 46.000000, 3035
1705842771879, 50, 103, 17, 86, 33.560528, 51.000000, 2540
1705842774481, 50, 66, 11, 55, 52.043087, 78.000000, 1250
1705842775784, 50, 66, 11, 55, 56.968513, 85.000000, 1462
1705842779536, 50, 85, 14, 71, 40.401080, 61.000000, 4424
1705842784328, 50, 64, 10, 54, 56.366150, 84.000000, 2223
1705842786614, 50, 12, 2, 10, 234.816406, 350.000000, 38
1705842786709, 50, 30, 5, 25, 104.498438, 156.000000, 247
1705842787016, 50, 76, 12, 64, 43.389777, 65.000000, 3303
1705842790377, 50, 20, 3, 17, 132.132422, 197.000000, 101
1705842790531, 50, 100, 16, 84, 32.767168, 49.000000, 2962
1705842793544, 50, 26, 4, 22, 96.108398, 144.000000, 176
1705842793771, 50, 115, 19, 96, 30.887908, 46.000000, 3153
1705842796976, 50, 114, 19, 95, 28.459156, 43.000000, 2383
1705842801538, 50, 76, 12, 64, 45.984375, 68.000000, 3241
1705842805127, 50, 40, 6, 34, 68.887708, 103.000000, 666
1705842805847, 50, 76, 12, 64, 46.889134, 70.000000, 2545
1705842808705, 50, 109, 18, 91, 32.837048, 49.000000, 3972
1705842812729, 50, 15, 2, 13, 169.110156, 250.000000, 79
1705842812858, 50, 44, 7, 37, 86.363636, 129.000000, 715
1705842813635, 50, 85, 14, 71, 41.934926, 62.000000, 2319
1705842816015, 50, 85, 14, 71, 42.575368, 63.000000, 2160
1705842818463, 50, 80, 13, 67, 45.329102, 67.000000, 1859
1705842820374, 50, 106, 17, 89, 32.952245, 49.000000, 6499
1705842829224, 50, 50, 8, 42, 68.281250, 98.000000, 1547
1705842831121, 50, 12, 2, 10, 240.324219, 357.000000, 54
1705842831233, 50, 108, 18, 90, 29.811198, 44.000000, 3234
1705842834531, 50, 51, 8, 43, 69.590993, 97.000000, 1209
1705842835792, 50, 25, 4, 21, 120.740625, 181.000000, 106
1705842835950, 50, 49, 8, 41, 74.346142, 111.000000, 977
1705842836980, 50, 75, 12, 63, 45.660195, 69.000000, 2426
1705842839457, 50, 116, 19, 97, 28.510237, 42.000000, 3374
1705842842883, 50, 117, 19, 98, 28.610777, 42.000000, 2811
1705842845745, 50, 99, 16, 83, 35.457110, 53.000000, 4650
1705842852608, 50, 20, 3, 17, 124.312500, 181.000000, 433
1705842853384, 50, 112, 18, 94, 29.674247, 45.000000, 3955
1705842857396, 50, 54, 9, 45, 65.367477, 99.000000, 1179
1705842858640, 50, 38, 6, 32, 86.445724, 129.000000, 426
1705842859135, 50, 21, 3, 18, 124.287202, 186.000000, 95
1705842859295, 50, 24, 4, 20, 121.303711, 181.000000, 185
1705842859538, 50, 91, 15, 76, 40.818853, 61.000000, 2890
1705842862489, 50, 66, 11, 55, 54.397017, 81.000000, 1956
1705842864506, 50, 40, 6, 34, 82.902344, 124.000000, 479
1705842865037, 50, 84, 14, 70, 43.632440, 65.000000, 2565
1705842869978, 50, 97, 16, 81, 33.436695, 48.000000, 3928
1705842874294, 50, 38, 6, 32, 78.199527, 117.000000, 848
1705842875207, 50, 40, 6, 34, 83.109375, 124.000000, 924
1705842876196, 50, 19, 3, 16, 144.440584, 216.000000, 102
1705842876379, 50, 115, 19, 96, 30.125476, 45.000000, 5012
1705842881444, 50, 25, 4, 21, 115.475625, 162.000000, 107
1705842881606, 50, 103, 17, 86, 36.863376, 55.000000, 4830
1705842886501, 50, 81, 13, 68, 40.994406, 61.000000, 2073
1705842888642, 50, 18, 3, 15, 141.122396, 208.000000, 82
1705842888782, 50, 39, 6, 33, 88.415465, 132.000000, 452
1705842891636, 50, 86, 14, 72, 43.805959, 65.000000, 4966
1705842896957, 50, 13, 2, 11, 194.007287, 291.000000, 956
1705842897969, 50, 30, 5, 25, 93.704753, 139.000000, 486
1705842898508, 50, 79, 13, 66, 46.060275, 69.000000, 3010
1705842901571, 50, 86, 14, 72, 43.276526, 64.000000, 4585
1705842906218, 50, 16, 2, 14, 151.533691, 218.000000, 42
1705842906314, 50, 26, 4, 22, 115.269231, 172.000000, 115
1705842906487, 50, 18, 3, 15, 145.161458, 205.000000, 68
1705842906616, 50, 76, 12, 64, 43.018606, 64.000000, 1365
1705842908034, 50, 108, 18, 90, 29.441696, 45.000000, 4870
1705842915243, 50, 48, 8, 40, 68.520345, 99.000000, 1939
1705842917558, 50, 104, 17, 87, 36.079177, 55.000000, 5370
1705842922984, 50, 40, 6, 34, 81.640625, 122.000000, 330
1705842923368, 50, 91, 15, 76, 45.591346, 69.000000, 3397
1705842926819, 50, 90, 15, 75, 38.431011, 57.000000, 5025
1705842931901, 50, 63, 10, 53, 53.861607, 81.000000, 1213
1705842933168, 50, 117, 19, 98, 30.042735, 45.000000, 3138
1705842936371, 50, 48, 8, 40, 77.311198, 115.000000, 747
1705842937173, 50, 43, 7, 36, 83.642805, 125.000000, 479
1705842937709, 50, 50, 8, 42, 63.293750, 95.000000, 606
1705842940741, 50, 55, 9, 46, 63.465341, 92.000000, 2499
1705842943598, 50, 116, 19, 97, 31.258890, 46.000000, 4022
1705842947682, 50, 34, 5, 29, 87.645450, 128.000000, 348
1705842948091, 50, 51, 8, 43, 72.588848, 108.000000, 805
1705842948962, 50, 114, 19, 95, 32.158306, 48.000000, 4311
1705842953325, 50, 39, 6, 33, 85.028045, 125.000000, 357
1705842953738, 50, 33, 5, 28, 80.979167, 121.000000, 224
1705842954013, 50, 52, 8, 44, 61.259014, 91.000000, 650
1705842954717, 50, 58, 9, 49, 60.369881, 88.000000, 1666
1705842956446, 50, 30, 5, 25, 104.128646, 154.000000, 229
1705842958856, 50, 112, 18, 94, 29.985491, 44.000000, 5862
1705842965074, 50, 63, 10, 53, 56.090278, 84.000000, 1617
1705842966752, 50, 117, 19, 98, 28.253873, 41.000000, 2579
1705842969384, 50, 82, 13, 69, 40.895770, 61.000000, 2314
1705842971758, 50, 62, 10, 52, 59.063760, 88.000000, 1011
1705842972830, 50, 81, 13, 68, 43.568769, 65.000000, 2346
1705842975230, 50, 62, 10, 52, 61.562500, 93.000000, 1568
1705842976850, 50, 115, 19, 96, 31.682269, 47.000000, 4855
1705842981758, 50, 114, 19, 95, 32.306812, 48.000000, 2783
1705842984604, 50, 57, 9, 48, 60.209293, 90.000000, 1815
1705842988882, 50, 84, 14, 70, 35.718657, 53.000000, 3684
1705842992950, 50, 100, 16, 84, 34.760781, 53.000000, 4002
1705842997020, 50, 55, 9, 46, 67.042187, 100.000000, 1748
1705842998821, 50, 26, 4, 22, 115.029823, 172.000000, 212
1705842999088, 50, 39, 6, 33, 81.554688, 122.000000, 357
1705842999497, 50, 62, 10, 52, 58.992881, 88.000000, 2021
1705843001575, 50, 87, 14, 73, 43.058369, 64.000000, 2723
1705843004353, 50, 39, 6, 33, 75.028846, 110.000000, 349
1705843004755, 50, 19, 3, 16, 131.576891, 195.000000, 94
1705843004903, 50, 37, 6, 31, 81.458932, 122.000000, 528
1705843007908, 50, 28, 4, 24, 105.106306, 157.000000, 1156
1705843009450, 50, 93, 15, 78, 35.784610, 52.000000, 3146
1705843012652, 50, 88, 14, 74, 38.323864, 57.000000, 2138
1705843014846, 50, 116, 19, 97, 30.450700, 45.000000, 3839
1705843018741, 50, 86, 14, 72, 39.604015, 59.000000, 2934
1705843021741, 50, 63, 10, 53, 56.310144, 84.000000, 1423
1705843023223, 50, 106, 17, 89, 33.101415, 49.000000, 5332
1705843028609, 50, 43, 7, 36, 83.109375, 124.000000, 731
1705843029392, 50, 25, 4, 21, 103.983750, 154.000000, 109
1705843029554, 50, 42, 7, 35, 80.368304, 119.000000, 462
1705843032594, 50, 67, 11, 56, 59.761894, 89.000000, 3108
1705843036070, 50, 91, 15, 76, 39.670330, 59.000000, 2186
1705843038311, 50, 31, 5, 26, 96.212450, 144.000000, 226
1705843038599, 50, 36, 6, 30, 87.947483, 131.000000, 384
1705843039047, 50, 90, 15, 75, 39.776215, 59.000000, 2474
1705843041573, 50, 115, 19, 96, 30.312840, 45.000000, 4144
1705843045773, 50, 64, 10, 54, 58.770691, 88.000000, 1918
1705843047744, 50, 98, 16, 82, 38.183096, 57.000000, 4967
1705843052765, 50, 13, 2, 11, 191.078726, 282.000000, 52
1705843052871, 50, 86, 14, 72, 41.572584, 62.000000, 2518
1705843057887, 50, 37, 6, 31, 90.907939, 135.000000, 1048
1705843059296, 50, 43, 7, 36, 83.849927, 125.000000, 811
1705843060159, 50, 109, 18, 91, 31.346044, 47.000000, 3677
1705843063898, 50, 69, 11, 58, 50.989810, 77.000000, 1611
1705843065572, 50, 62, 10, 52, 54.934602, 83.000000, 1370
1705843066994, 50, 45, 7, 38, 80.486111, 115.000000, 739
1705843067786, 50, 31, 5, 26, 92.635585, 138.000000, 238
1705843068075, 50, 18, 3, 15, 146.140625, 207.000000, 63
1705843068189, 50, 111, 18, 93, 32.255068, 49.000000, 3384
1705843071634, 50, 16, 2, 14, 171.981445, 257.000000, 46
1705843073863, 50, 28, 4, 24, 110.104632, 165.000000, 579
1705843074856, 50, 54, 9, 45, 65.096644, 97.000000, 1400
1705843076309, 50, 27, 4, 23, 98.156250, 142.000000, 181
1705843076545, 50, 82, 13, 69, 45.472561, 69.000000, 2143
1705843078741, 50, 106, 17, 89, 31.174086, 46.000000, 1960
1705843080753, 50, 36, 6, 30, 93.962240, 140.000000, 372
1705843081179, 50, 62, 10, 52, 59.949597, 89.000000, 1448
1705843082679, 50, 50, 8, 42, 68.132969, 101.000000, 1487
1705843084227, 50, 103, 17, 86, 33.515701, 51.000000, 4020
1705843088301, 50, 12, 2, 10, 199.107422, 294.000000, 34
1705843090539, 50, 108, 18, 90, 30.512153, 45.000000, 4928
1705843095837, 50, 14, 2, 12, 192.458705, 262.000000, 658
1705843096578, 50, 25, 4, 21, 116.964375, 175.000000, 341
1705843096982, 50, 58, 9, 49, 64.072737, 97.000000, 846
1705843097880, 50, 117, 19, 98, 30.283787, 45.000000, 4356
1705843102299, 50, 108, 18, 90, 30.416504, 45.000000, 3923
1705843106276, 50, 46, 7, 39, 75.864470, 111.000000, 520
1705843106848, 50, 39, 6, 33, 82.477965, 123.000000, 453
1705843107355, 50, 111, 18, 93, 31.003097, 47.000000, 4986
1705843112401, 50, 67, 11, 56, 55.957556, 83.000000, 1594
1705843116327, 50, 84, 14, 70, 41.114955, 61.000000, 3798
1705843120465, 50, 85, 14, 71, 39.733640, 59.000000, 1820
1705843122337, 50, 70, 11, 59, 48.871875, 73.000000, 1794
1705843124184, 50, 50, 8, 42, 70.335156, 105.000000, 1034
1705843125271, 50, 19, 3, 16, 147.145559, 220.000000, 91
1705843125420, 50, 13, 2, 11, 190.061899, 283.000000, 49
1705843125520, 50, 73, 12, 61, 49.760220, 75.000000, 2490
1705843128070, 50, 72, 12, 60, 47.796441, 71.000000, 1842
1705843129964, 50, 82, 13, 69, 47.318979, 70.000000, 1395
1705843131413, 50, 64, 10, 54, 64.111572, 97.000000, 1396
1705843134972, 50, 103, 17, 86, 33.247118, 49.000000, 5116
1705843140449, 50, 76, 12, 64, 49.032072, 73.000000, 2532
1705843143037, 50, 97, 16, 81, 35.715770, 53.000000, 3218
1705843146308, 50, 33, 5, 28, 91.341619, 137.000000, 298
1705843146669, 50, 118, 19, 99, 30.507349, 45.000000, 2383
1705843149112, 50, 52, 8, 44, 74.475661, 105.000000, 883
1705843150061, 50, 18, 3, 15, 139.225260, 196.000000, 82
1705843150206, 50, 69, 11, 58, 51.329257, 76.000000, 1343
1705843151603, 50, 12, 2, 10, 223.708984, 332.000000, 49
1705843151705, 50, 63, 10, 53, 56.539807, 84.000000, 1656
1705843155697, 50, 22, 3, 19, 122.247869, 183.000000, 408
1705843156480, 50, 92, 15, 77, 38.459834, 57.000000, 4158
1705843160692, 50, 74, 12, 62, 55.328547, 82.000000, 1916
1705843162661, 50, 18, 3, 15, 149.078125, 223.000000, 65
1705843162779, 50, 81, 13, 68, 48.413966, 72.000000, 2694
1705843165528, 50, 16, 2, 14, 148.160156, 214.000000, 54
1705843165639, 50, 63, 10, 53, 57.655010, 87.000000, 1199
1705843166891, 50, 26, 4, 22, 113.906250, 165.000000, 120
1705843167065, 50, 45, 7, 38, 78.177083, 113.000000, 535
1705843167665, 50, 21, 3, 18, 119.045759, 178.000000, 109
1705843169999, 50, 82, 13, 69, 42.420922, 63.000000, 5352
1705843175701, 50, 99, 16, 83, 35.631787, 52.000000, 3668
1705843179434, 50, 31, 5, 26, 95.289315, 136.000000, 460
1705843179957, 50, 37, 6, 31, 92.793497, 139.000000, 341
1705843180360, 50, 117, 19, 98, 30.953325, 46.000000, 5876
1705843186300, 50, 80, 13, 67, 44.305762, 67.000000, 2269
1705843188626, 50, 102, 17, 85, 30.469727, 45.000000, 3164
1705843191849, 50, 28, 4, 24, 104.278460, 148.000000, 190
1705843192100, 50, 76, 12, 64, 43.741776, 65.000000, 2128
1705843194279, 50, 43, 7, 36, 77.152980, 115.000000, 582
1705843197304, 50, 109, 18, 91, 34.375000, 51.000000, 5607
1705843203309, 50, 34, 5, 29, 105.259651, 156.000000, 1791
1705843205165, 50, 66, 11, 55, 49.840199, 75.000000, 2070
1705843207304, 50, 31, 5, 26, 95.914315, 143.000000, 228
1705843207589, 50, 70, 11, 59, 50.527790, 75.000000, 2354
1705843210008, 50, 84, 14, 70, 42.067708, 63.000000, 2776
1705843212838, 50, 24, 4, 20, 120.557780, 180.000000, 169
1705843213061, 50, 48, 8, 40, 68.618164, 102.000000, 934
1705843214049, 50, 15, 2, 13, 153.943359, 228.000000, 71
1705843214174, 50, 70, 11, 59, 52.334821, 78.000000, 1534
1705843217938, 50, 34, 5, 29, 92.654871, 138.000000, 1025
1705843219312, 50, 105, 17, 88, 34.893564, 53.000000, 4057
1705843223502, 50, 74, 12, 62, 50.971706, 76.000000, 2306
1705843225860, 50, 102, 17, 85, 33.969516, 49.000000, 2674
1705843228589, 50, 103, 17, 86, 32.886833, 49.000000, 2391
1705843231041, 50, 92, 15, 77, 36.333815, 54.000000, 3276
1705843234381, 50, 34, 5, 29, 91.566198, 137.000000, 688
1705843235134, 50, 49, 8, 41, 70.522959, 105.000000, 771
1705843235968, 50, 15, 2, 13, 167.437500, 240.000000, 41
1705843236066, 50, 54, 9, 45, 69.001302, 100.000000, 1130
1705843239513, 50, 116, 19, 97, 29.457166, 44.000000, 5786
1705843245648, 50, 54, 9, 45, 67.500506, 99.000000, 2183
1705843247884, 50, 54, 9, 45, 63.187066, 94.000000, 1187
1705843249131, 50, 63, 10, 53, 52.023810, 79.000000, 1152
1705843250344, 50, 67, 11, 56, 49.892724, 75.000000, 1479
1705843251884, 50, 74, 12, 62, 48.491317, 72.000000, 2949
1705843254885, 50, 98, 16, 82, 36.139987, 55.000000, 2131
1705843257069, 50, 110, 18, 92, 34.335085, 50.000000, 3831
1705843260962, 50, 21, 3, 18, 114.405134, 171.000000, 77
1705843261102, 50, 14, 2, 12, 190.491629, 268.000000, 40
1705843263226, 50, 80, 13, 67, 45.236328, 67.000000, 3692
1705843267267, 50, 45, 7, 38, 71.151042, 106.000000, 588
1705843267908, 50, 54, 9, 45, 60.669488, 90.000000, 1028
1705843268988, 50, 105, 17, 88, 32.076637, 47.000000, 2378
1705843271418, 50, 106, 17, 89, 31.870209, 47.000000, 4419
1705843275890, 50, 37, 6, 31, 78.200486, 117.000000, 397
1705843276339, 50, 31, 5, 26, 102.175151, 149.000000, 233
1705843276623, 50, 98, 16, 82, 37.534279, 50.000000, 2783
1705843279470, 50, 116, 19, 97, 31.798895, 47.000000, 3431
1705843282955, 50, 68, 11, 57, 52.444652, 79.000000, 2183
1705843287348, 50, 14, 2, 12, 171.686384, 257.000000, 553
1705843288247, 50, 115, 19, 96, 30.447554, 45.000000, 2875
1705843291186, 50, 44, 7, 37, 78.435724, 114.000000, 731
1705843291970, 50, 106, 17, 89, 31.563974, 47.000000, 2019
1705843294053, 50, 70, 11, 59, 54.073661, 81.000000, 1565
1705843295671, 50, 106, 17, 89, 32.000884, 49.000000, 2832
1705843298556, 50, 105, 17, 88, 35.749405, 53.000000, 2696
1705843301306, 50, 33, 5, 28, 98.383286, 147.000000, 262
1705843301622, 50, 114, 19, 95, 33.105469, 49.000000, 3444
1705843305120, 50, 42, 7, 35, 85.704985, 128.000000, 440
1705843307410, 50, 30, 5, 25, 104.414063, 156.000000, 714
1705843308490, 50, 49, 8, 41, 68.250957, 100.000000, 1234
1705843309784, 50, 58, 9, 49, 56.508621, 84.000000, 1163
1705843311017, 50, 58, 9, 49, 66.047010, 99.000000, 1598
1705843312667, 50, 44, 7, 37, 75.568182, 110.000000, 651
1705843313369, 50, 38, 6, 32, 83.671875, 125.000000, 426
1705843313848, 50, 15, 2, 13, 177.865625, 266.000000, 40
1705843313940, 50, 28, 4, 24, 98.127511, 147.000000, 191
1705843314184, 50, 72, 12, 60, 51.152452, 76.000000, 1668
1705843315906, 50, 116, 19, 97, 30.893252, 47.000000, 4972
1705843322847, 50, 103, 17, 86, 36.011074, 55.000000, 5996
1705843329191, 50, 25, 4, 21, 116.488125, 173.000000, 325
1705843329605, 50, 66, 11, 55, 52.491359, 78.000000, 2339
1705843331995, 50, 112, 18, 94, 32.656250, 48.000000, 2885
1705843334933, 50, 90, 15, 75, 40.520226, 61.000000, 4080
1705843339072, 50, 105, 17, 88, 32.071131, 49.000000, 2966
1705843342103, 50, 112, 18, 94, 31.674456, 47.000000, 3285
1705843345440, 50, 37, 6, 31, 95.361064, 143.000000, 418
1705843345911, 50, 66, 11, 55, 50.159446, 75.000000, 1459
1705843347421, 50, 58, 9, 49, 60.219558, 91.000000, 827
1705843353146, 50, 105, 17, 88, 37.025446, 55.000000, 7199
1705843360704, 50, 116, 19, 97, 31.298693, 47.000000, 5457
1705843366218, 50, 103, 17, 86, 36.294979, 54.000000, 4363
1705843370650, 50, 48, 8, 40, 64.013672, 97.000000, 860
1705843371569, 50, 38, 6, 32, 87.597656, 131.000000, 1023
1705843372643, 50, 94, 15, 79, 41.964013, 62.000000, 3237
1705843375934, 50, 66, 11, 55, 48.244644, 72.000000, 1306
1705843377292, 50, 99, 16, 83, 37.979009, 56.000000, 2122
1705843379466, 50, 45, 7, 38, 70.454861, 98.000000, 533
1705843380056, 50, 99, 16, 83, 37.182371, 55.000000, 4644
1705843387010, 50, 84, 14, 70, 40.502232, 61.000000, 2814
1705843390182, 50, 55, 9, 46, 57.985511, 86.000000, 2287
1705843392523, 50, 27, 4, 23, 117.937500, 175.000000, 133
1705843392708, 50, 92, 15, 77, 35.657269, 53.000000, 2240
1705843395001, 50, 90, 15, 75, 41.318316, 61.000000, 3124
1705843398180, 50, 80, 13, 67, 44.197266, 67.000000, 1946
1705843400179, 50, 98, 16, 82, 36.988202, 55.000000, 2598
1705843402837, 50, 74, 12, 62, 49.894742, 74.000000, 1653
1705843404544, 50, 50, 8, 42, 67.841875, 99.000000, 762
1705843405357, 50, 94, 15, 79, 37.494182, 56.000000, 2142
1705843409531, 50, 38, 6, 32, 81.141422, 121.000000, 1492
1705843411358, 50, 18, 3, 15, 154.617188, 230.000000, 58
1705843411468, 50, 54, 9, 45, 68.446181, 99.000000, 1102
1705843412626, 50, 104, 17, 87, 30.615234, 45.000000, 2306
1705843414988, 50, 103, 17, 86, 35.266952, 51.000000, 3314
1705843418356, 50, 40, 6, 34, 79.859375, 119.000000, 380
1705843418788, 50, 87, 14, 73, 39.463901, 59.000000, 1329
1705843420178, 50, 72, 12, 60, 49.114095, 73.000000, 2567
1705843422796, 50, 97, 16, 81, 38.869201, 59.000000, 2656
1705843425504, 50, 45, 7, 38, 76.098958, 106.000000, 540
1705843428082, 50, 94, 15, 79, 37.943692, 56.000000, 6129
1705843434582, 50, 92, 15, 77, 37.093240, 55.000000, 2508
1705843437142, 50, 31, 5, 26, 94.466230, 136.000000, 770
1705843437972, 50, 112, 18, 94, 28.918806, 43.000000, 2351
1705843440377, 50, 18, 3, 15, 140.423394, 205.000000, 79
1705843440510, 50, 31, 5, 26, 106.817540, 160.000000, 237
1705843440800, 50, 57, 9, 48, 58.072917, 87.000000, 1259
1705843442118, 50, 106, 17, 89, 32.852300, 48.000000, 2983
1705843445163, 50, 87, 14, 73, 41.067708, 61.000000, 1826
1705843447041, 50, 61, 10, 51, 59.362193, 89.000000, 1804
